//MAP CONVERTED BY dmm2tgm.py THIS HEADER COMMENT PREVENTS RECONVERSION, DO NOT REMOVE
"a" = (
/turf/template_noop,
/area/template_noop)
"b" = (
/turf/closed/wall,
/area/station/maintenance/department/medical/morgue)
"c" = (
/obj/machinery/atmospherics/pipe/smart/manifold4w/supply/hidden/layer4,
/obj/machinery/atmospherics/pipe/smart/manifold4w/scrubbers/hidden/layer2,
/obj/structure/cable,
/obj/effect/decal/cleanable/dirt,
/obj/effect/spawner/random/trash/food_packaging,
/turf/open/floor/catwalk_floor,
/area/station/maintenance/department/medical/morgue)
"d" = (
/obj/effect/turf_decal/sand/plating,
/obj/structure/sign/warning/secure_area{
	desc = "A warning sign which reads 'CAVE IN HAZARD: WEAR PROTECTIVE HEAD GEAR'.";
	name = "\improper CAVE IN HAZARD sign";
	pixel_x = -32
	},
/turf/open/floor/plating,
/area/station/maintenance/department/medical/morgue)
"e" = (
/obj/effect/turf_decal/sand/plating,
/obj/structure/barricade/wooden,
/turf/open/floor/plating,
/area/station/maintenance/department/medical/morgue)
"h" = (
/turf/closed/wall/rock/porous,
/area/station/maintenance/department/medical/morgue)
"i" = (
/obj/effect/decal/cleanable/dirt,
/turf/open/floor/iron/smooth,
/area/station/maintenance/department/medical/morgue)
"j" = (
/turf/closed/wall/rust,
/area/station/maintenance/department/medical/morgue)
"o" = (
/obj/effect/turf_decal/sand/plating,
/turf/open/floor/plating,
/area/station/maintenance/department/medical/morgue)
"p" = (
/obj/effect/decal/cleanable/cobweb/cobweb2,
/obj/item/shovel,
/turf/open/misc/asteroid,
/area/station/maintenance/department/medical/morgue)
"u" = (
/obj/machinery/atmospherics/pipe/smart/manifold4w/supply/hidden/layer4,
/obj/machinery/atmospherics/pipe/smart/manifold4w/scrubbers/hidden/layer2,
/obj/structure/cable,
/obj/effect/turf_decal/sand/plating,
/turf/open/floor/plating,
/area/station/maintenance/department/medical/morgue)
"w" = (
/obj/machinery/atmospherics/pipe/smart/manifold4w/supply/hidden/layer4,
/obj/machinery/atmospherics/pipe/smart/manifold4w/scrubbers/hidden/layer2,
/obj/structure/cable,
/obj/effect/decal/cleanable/dirt,
/turf/open/floor/plating,
/area/station/maintenance/department/medical/morgue)
"x" = (
/obj/item/clothing/head/hardhat,
/turf/open/misc/asteroid,
/area/station/maintenance/department/medical/morgue)
"y" = (
/obj/modular_map_root/tramstation{
	key = "maintenance_science_west_attachment"
	},
/turf/open/floor/plating,
/area/station/maintenance/department/medical/morgue)
"z" = (
/obj/machinery/atmospherics/pipe/smart/manifold4w/supply/hidden/layer4,
/obj/machinery/atmospherics/pipe/smart/manifold4w/scrubbers/hidden/layer2,
/obj/structure/cable,
/obj/effect/turf_decal/sand/plating,
/obj/structure/sign/warning/secure_area{
	desc = "A warning sign which reads 'CAVE IN HAZARD: WEAR PROTECTIVE HEAD GEAR'.";
	name = "\improper CAVE IN HAZARD sign";
	pixel_y = -32
	},
/turf/open/floor/plating,
/area/station/maintenance/department/medical/morgue)
"A" = (
/obj/machinery/atmospherics/pipe/smart/manifold4w/supply/hidden/layer4,
/obj/machinery/atmospherics/pipe/smart/manifold4w/scrubbers/hidden/layer2,
/obj/structure/cable,
/obj/effect/decal/cleanable/dirt,
/turf/open/floor/catwalk_floor,
/area/station/maintenance/department/medical/morgue)
"B" = (
/obj/effect/spawner/random/engineering/tool,
/turf/open/misc/asteroid,
/area/station/maintenance/department/medical/morgue)
"D" = (
/obj/structure/closet/crate,
/obj/effect/spawner/random/engineering/material_cheap,
/obj/effect/spawner/random/engineering/material_cheap,
/obj/effect/spawner/random/engineering/material_cheap,
/turf/open/misc/asteroid,
/area/station/maintenance/department/medical/morgue)
"F" = (
/obj/structure/barricade/wooden,
/turf/open/misc/asteroid,
/area/station/maintenance/department/medical/morgue)
"H" = (
/obj/structure/ore_box,
/turf/open/misc/asteroid,
/area/station/maintenance/department/medical/morgue)
"I" = (
/obj/item/stack/ore/glass,
/turf/open/misc/asteroid,
/area/station/maintenance/department/medical/morgue)
"M" = (
/obj/item/storage/toolbox/mechanical,
/turf/open/misc/asteroid,
/area/station/maintenance/department/medical/morgue)
"N" = (
/obj/item/clothing/head/cone{
	pixel_x = 11;
	pixel_y = -10
	},
/obj/item/clothing/head/cone{
	pixel_x = -9;
	pixel_y = -10
	},
/turf/open/misc/asteroid,
/area/station/maintenance/department/medical/morgue)
"O" = (
/obj/effect/spawner/random/structure/girder,
/obj/effect/turf_decal/sand/plating,
/turf/open/floor/plating,
/area/station/maintenance/department/medical/morgue)
"P" = (
/obj/effect/decal/cleanable/dirt,
/turf/open/floor/plating,
/area/station/maintenance/department/medical/morgue)
"V" = (
/obj/machinery/atmospherics/pipe/smart/manifold4w/supply/hidden/layer4,
/obj/machinery/atmospherics/pipe/smart/manifold4w/scrubbers/hidden/layer2,
/obj/structure/cable,
/obj/modular_map_connector,
/obj/effect/decal/cleanable/dirt,
/turf/open/floor/catwalk_floor,
/area/station/maintenance/department/medical/morgue)
"W" = (
/turf/open/misc/asteroid,
/area/station/maintenance/department/medical/morgue)
"X" = (
/turf/closed/mineral/random/stationside/asteroid/porus,
/area/station/maintenance/department/medical/morgue)
"Y" = (
/obj/effect/turf_decal/sand/plating,
/obj/item/clothing/head/cone{
	pixel_x = -9;
	pixel_y = -10
	},
/obj/item/clothing/head/cone{
	pixel_x = -9;
	pixel_y = 8
	},
/turf/open/floor/plating,
/area/station/maintenance/department/medical/morgue)

(1,1,1) = {"
a
y
a
a
a
a
a
a
a
a
a
a
a
a
"}
(2,1,1) = {"
A
A
A
c
A
w
u
u
b
a
a
a
a
a
"}
(3,1,1) = {"
V
b
j
b
h
h
j
z
b
a
a
a
a
a
"}
(4,1,1) = {"
a
a
a
a
a
a
O
u
o
W
W
X
X
X
"}
(5,1,1) = {"
a
a
a
a
a
a
h
u
W
x
N
F
W
h
"}
(6,1,1) = {"
a
a
a
a
a
a
a
a
a
a
I
X
W
h
"}
(7,1,1) = {"
a
a
a
a
a
a
a
a
a
a
a
X
W
X
"}
(8,1,1) = {"
a
a
a
a
a
a
a
a
a
a
a
X
W
X
"}
(9,1,1) = {"
a
a
a
a
a
a
a
a
a
a
X
X
o
W
"}
(10,1,1) = {"
a
a
a
a
a
a
a
a
a
a
X
D
I
W
"}
(11,1,1) = {"
a
a
a
a
a
a
a
a
a
a
X
H
W
B
"}
(12,1,1) = {"
a
a
a
a
a
a
a
a
a
a
X
M
o
W
"}
(13,1,1) = {"
a
a
a
a
a
a
a
a
a
a
h
p
o
I
"}
(14,1,1) = {"
a
a
a
a
a
a
a
a
a
a
h
h
W
X
"}
(15,1,1) = {"
a
a
a
a
a
a
a
a
a
a
a
o
W
X
"}
(16,1,1) = {"
a
a
a
a
a
a
a
a
a
a
a
O
o
h
"}
(17,1,1) = {"
a
a
a
a
a
a
a
a
a
b
b
b
e
b
"}
(18,1,1) = {"
a
a
a
a
a
a
a
a
a
i
P
d
Y
b
"}
(19,1,1) = {"
a
a
a
a
a
a
a
a
a
a
a
a
a
a
"}
