//MAP CONVERTED BY dmm2tgm.py THIS HEADER COMMENT PREVENTS RECONVERSION, DO NOT REMOVE
"a" = (
/turf/closed/wall,
/area/station/maintenance/department/medical/morgue)
"k" = (
/obj/effect/decal/cleanable/dirt,
/obj/structure/sign/poster/official/plasma_effects{
	pixel_y = 32
	},
/turf/open/floor/iron/smooth,
/area/station/maintenance/department/medical/morgue)
"l" = (
/obj/structure/tank_holder/extinguisher,
/obj/effect/decal/cleanable/dirt,
/obj/effect/decal/cleanable/cobweb,
/turf/open/floor/iron/smooth,
/area/station/maintenance/department/medical/morgue)
"m" = (
/obj/structure/tank_holder/extinguisher,
/obj/effect/decal/cleanable/dirt,
/turf/open/floor/iron/smooth,
/area/station/maintenance/department/medical/morgue)
"n" = (
/obj/machinery/vending/wallmed/directional/west,
/obj/effect/decal/cleanable/dirt,
/turf/open/floor/iron/smooth,
/area/station/maintenance/department/medical/morgue)
"s" = (
/obj/effect/decal/cleanable/dirt,
/turf/open/floor/iron/smooth,
/area/station/maintenance/department/medical/morgue)
"y" = (
/obj/structure/window/reinforced/spawner/east,
/obj/structure/closet/firecloset,
/obj/effect/decal/cleanable/dirt,
/obj/effect/turf_decal/stripes/white/line{
	dir = 1
	},
/turf/open/floor/plating,
/area/station/maintenance/department/medical/morgue)
"J" = (
/obj/structure/reagent_dispensers/watertank,
/obj/effect/decal/cleanable/dirt,
/obj/effect/turf_decal/stripes/white/line{
	dir = 1
	},
/obj/machinery/light/small/directional/south,
/turf/open/floor/plating,
/area/station/maintenance/department/medical/morgue)
"S" = (
/obj/structure/window/reinforced/spawner/west,
/obj/structure/closet/firecloset,
/obj/effect/decal/cleanable/dirt,
/obj/effect/turf_decal/stripes/white/line{
	dir = 1
	},
/turf/open/floor/plating,
/area/station/maintenance/department/medical/morgue)
"U" = (
/obj/modular_map_connector,
/obj/effect/decal/cleanable/dirt,
/obj/machinery/door/airlock/maintenance_hatch,
/obj/effect/mapping_helpers/airlock/access/any/science/maintenance,
/obj/effect/mapping_helpers/airlock/unres{
	dir = 8
	},
/turf/open/floor/iron/smooth,
/area/station/maintenance/department/medical/morgue)

(1,1,1) = {"
l
n
s
y
"}
(2,1,1) = {"
k
s
s
J
"}
(3,1,1) = {"
m
s
s
S
"}
(4,1,1) = {"
a
U
a
a
"}
