//MAP CONVERTED BY dmm2tgm.py THIS HEADER COMMENT PREVENTS RECONVERSION, DO NOT REMOVE
"a" = (
/obj/effect/decal/cleanable/dirt,
/obj/effect/turf_decal/sand/plating,
/obj/effect/spawner/random/trash/food_packaging,
/turf/open/floor/plating,
/area/station/maintenance/department/medical/morgue)
"c" = (
/obj/effect/decal/cleanable/dirt,
/obj/effect/turf_decal/sand/plating,
/obj/structure/barricade/wooden,
/turf/open/floor/plating,
/area/station/maintenance/department/medical/morgue)
"g" = (
/obj/effect/spawner/random/structure/girder,
/obj/effect/turf_decal/sand/plating,
/turf/open/floor/plating,
/area/station/maintenance/department/medical/morgue)
"i" = (
/obj/effect/decal/cleanable/dirt,
/turf/open/floor/catwalk_floor,
/area/station/maintenance/department/medical/morgue)
"k" = (
/turf/closed/wall,
/area/station/maintenance/department/medical/morgue)
"l" = (
/obj/effect/turf_decal/sand/plating,
/obj/effect/spawner/random/structure/girder,
/turf/open/floor/plating,
/area/station/maintenance/department/medical/morgue)
"o" = (
/obj/effect/turf_decal/sand,
/obj/modular_map_connector,
/turf/open/floor/iron/smooth,
/area/station/maintenance/department/medical/morgue)
"t" = (
/obj/effect/turf_decal/sand,
/obj/item/stack/ore/glass,
/turf/open/floor/iron/smooth,
/area/station/maintenance/department/medical/morgue)
"w" = (
/obj/effect/turf_decal/sand,
/obj/structure/rack,
/obj/item/storage/bag/ore,
/turf/open/floor/iron/smooth,
/area/station/maintenance/department/medical/morgue)
"y" = (
/obj/effect/turf_decal/sand/plating,
/turf/open/floor/plating,
/area/station/maintenance/department/medical/morgue)
"F" = (
/obj/item/relic,
/obj/item/stack/ore/iron,
/obj/item/stack/ore/iron{
	pixel_x = -9;
	pixel_y = 11
	},
/turf/open/misc/asteroid,
/area/station/maintenance/department/medical/morgue)
"I" = (
/obj/item/stack/ore/glass,
/turf/open/misc/asteroid,
/area/station/maintenance/department/medical/morgue)
"K" = (
/obj/effect/turf_decal/sand/plating,
/obj/item/shovel,
/turf/open/floor/plating,
/area/station/maintenance/department/medical/morgue)
"L" = (
/obj/structure/barricade/wooden,
/turf/open/floor/catwalk_floor,
/area/station/maintenance/department/medical/morgue)
"S" = (
/turf/open/misc/asteroid,
/area/station/maintenance/department/medical/morgue)
"V" = (
/obj/effect/turf_decal/sand,
/obj/structure/rack,
/obj/effect/spawner/random/engineering/tool,
/turf/open/floor/iron/smooth,
/area/station/maintenance/department/medical/morgue)
"Y" = (
/obj/effect/decal/cleanable/dirt,
/obj/effect/turf_decal/sand/plating,
/obj/structure/sign/warning/secure_area/directional/east{
	desc = "A warning sign which reads 'CAVE IN HAZARD: WEAR PROTECTIVE HEAD GEAR'.";
	name = "\improper CAVE IN HAZARD sign"
	},
/turf/open/floor/plating,
/area/station/maintenance/department/medical/morgue)

(1,1,1) = {"
y
S
I
S
"}
(2,1,1) = {"
w
S
F
I
"}
(3,1,1) = {"
V
t
K
S
"}
(4,1,1) = {"
k
o
y
g
"}
(5,1,1) = {"
c
Y
a
L
"}
(6,1,1) = {"
i
k
l
k
"}
