//MAP CONVERTED BY dmm2tgm.py THIS HEADER COMMENT PREVENTS RECONVERSION, DO NOT REMOVE
"a" = (
/turf/closed/wall,
/area/station/maintenance/department/medical/morgue)
"b" = (
/obj/effect/decal/cleanable/dirt,
/obj/structure/table,
/obj/item/toy/plush/beeplushie,
/turf/open/floor/iron/smooth,
/area/station/maintenance/department/medical/morgue)
"f" = (
/obj/effect/decal/cleanable/dirt,
/obj/structure/rack,
/obj/effect/spawner/random/maintenance/three,
/obj/effect/spawner/random/engineering/flashlight,
/turf/open/floor/iron/smooth,
/area/station/maintenance/department/medical/morgue)
"m" = (
/obj/effect/decal/cleanable/dirt,
/turf/open/floor/iron/smooth,
/area/station/maintenance/department/medical/morgue)
"p" = (
/obj/effect/decal/cleanable/dirt,
/obj/structure/girder,
/turf/open/floor/iron/smooth,
/area/station/maintenance/department/medical/morgue)
"r" = (
/obj/effect/decal/cleanable/dirt,
/obj/machinery/door/airlock/maintenance_hatch,
/obj/modular_map_connector,
/obj/effect/mapping_helpers/airlock/unres{
	dir = 8
	},
/obj/effect/mapping_helpers/airlock/access/any/science/maintenance,
/turf/open/floor/iron/smooth,
/area/station/maintenance/department/medical/morgue)
"v" = (
/obj/effect/decal/cleanable/dirt,
/obj/structure/closet/emcloset,
/turf/open/floor/iron/smooth,
/area/station/maintenance/department/medical/morgue)
"Y" = (
/obj/effect/decal/cleanable/dirt,
/obj/structure/chair/stool/directional/west,
/obj/structure/sign/poster/contraband/random{
	pixel_y = 32
	},
/turf/open/floor/iron/smooth,
/area/station/maintenance/department/medical/morgue)

(1,1,1) = {"
b
m
m
f
"}
(2,1,1) = {"
Y
m
m
p
"}
(3,1,1) = {"
m
m
m
v
"}
(4,1,1) = {"
a
r
a
a
"}
