//MAP CONVERTED BY dmm2tgm.py THIS HEADER COMMENT PREVENTS RECONVERSION, DO NOT REMOVE
"a" = (
/turf/closed/wall/mineral/titanium,
/area/shuttle/supply)
"i" = (
/obj/machinery/door/poddoor{
	id = "QMLoaddoor";
	name = "Supply Dock Loading Door"
	},
/obj/machinery/conveyor{
	dir = 8;
	id = "QMLoad";
	name = "off ramp"
	},
/turf/open/floor/plating,
/area/shuttle/supply)
"j" = (
/obj/effect/turf_decal/loading_area{
	dir = 8
	},
/turf/open/floor/mineral/plastitanium,
/area/shuttle/supply)
"m" = (
/obj/machinery/door/airlock/shuttle{
	name = "Supply Shuttle Airlock"
	},
/obj/effect/decal/cleanable/dirt,
/obj/effect/mapping_helpers/airlock/access/all/supply/general,
/obj/docking_port/mobile/supply{
	dir = 4
	},
/turf/open/floor/mineral/plastitanium,
/area/shuttle/supply)
"r" = (
/obj/machinery/door/airlock/shuttle{
	name = "Supply Shuttle Airlock"
	},
/obj/effect/decal/cleanable/dirt,
/obj/effect/mapping_helpers/airlock/access/all/supply/general,
/turf/open/floor/mineral/plastitanium,
/area/shuttle/supply)
"t" = (
/obj/machinery/door/poddoor{
	id = "QMLoaddoor2";
	name = "Supply Dock Loading Door"
	},
/obj/machinery/conveyor{
	dir = 4;
	id = "QMLoad2";
	name = "on ramp"
	},
/turf/open/floor/plating,
/area/shuttle/supply)
"u" = (
/obj/effect/turf_decal/loading_area{
	dir = 4
	},
/turf/open/floor/mineral/plastitanium,
/area/shuttle/supply)
"y" = (
/obj/structure/sign/warning/fire,
/turf/closed/wall/mineral/titanium/nodiagonal,
/area/shuttle/supply)
"A" = (
/obj/effect/spawner/structure/window/reinforced/shuttle,
/obj/machinery/power/shuttle_engine/heater,
/turf/open/floor/plating,
/area/shuttle/supply)
"B" = (
/turf/template_noop,
/area/template_noop)
"C" = (
/obj/machinery/power/shuttle_engine/propulsion/burst/left,
/obj/effect/turf_decal/stripes/line,
/turf/open/floor/plating/airless,
/area/shuttle/supply)
"D" = (
/obj/machinery/power/shuttle_engine/propulsion,
/obj/effect/turf_decal/stripes/line,
/turf/open/floor/plating/airless,
/area/shuttle/supply)
"E" = (
/obj/machinery/power/shuttle_engine/propulsion/burst/right,
/obj/effect/turf_decal/stripes/line,
/turf/open/floor/plating/airless,
/area/shuttle/supply)
"F" = (
/obj/effect/turf_decal/stripes/line{
	dir = 6
	},
/obj/effect/turf_decal/tile/brown/opposingcorners,
/turf/open/floor/mineral/titanium/yellow,
/area/shuttle/supply)
"G" = (
/obj/effect/turf_decal/tile/brown/opposingcorners,
/turf/open/floor/mineral/titanium/yellow,
/area/shuttle/supply)
"I" = (
/obj/effect/turf_decal/stripes/line{
	dir = 8
	},
/obj/machinery/button/door/directional/west{
	id = "QMLoaddoor";
	name = "Off Ramp Toggle";
	pixel_y = 8;
	req_access = list("cargo")
	},
/obj/machinery/button/door/directional/west{
	id = "QMLoaddoor2";
	name = "On Ramp Toggle";
	pixel_y = -8;
	req_access = list("cargo")
	},
/obj/effect/turf_decal/tile/brown/opposingcorners,
/turf/open/floor/mineral/titanium/yellow,
/area/shuttle/supply)
"J" = (
/obj/effect/turf_decal/stripes/line{
	dir = 4
	},
/obj/effect/turf_decal/tile/brown/opposingcorners,
/turf/open/floor/mineral/titanium/yellow,
/area/shuttle/supply)
"K" = (
/obj/effect/turf_decal/stripes/corner{
	dir = 1
	},
/obj/effect/turf_decal/stripes/corner{
	dir = 8
	},
/obj/effect/turf_decal/tile/brown/opposingcorners,
/turf/open/floor/mineral/titanium/yellow,
/area/shuttle/supply)
"L" = (
/obj/effect/turf_decal/stripes/line,
/obj/effect/turf_decal/stripes/corner{
	dir = 1
	},
/obj/effect/turf_decal/tile/brown/opposingcorners,
/turf/open/floor/mineral/titanium/yellow,
/area/shuttle/supply)
"M" = (
/obj/effect/turf_decal/stripes/line{
	dir = 4
	},
/obj/structure/sign/departments/cargo/directional/east,
/obj/effect/turf_decal/tile/brown/opposingcorners,
/turf/open/floor/mineral/titanium/yellow,
/area/shuttle/supply)
"N" = (
/obj/effect/turf_decal/stripes/line,
/obj/effect/turf_decal/tile/brown/opposingcorners,
/turf/open/floor/mineral/titanium/yellow,
/area/shuttle/supply)
"O" = (
/obj/effect/turf_decal/stripes/line{
	dir = 1
	},
/obj/effect/turf_decal/stripes/corner{
	dir = 8
	},
/obj/effect/turf_decal/tile/brown/opposingcorners,
/turf/open/floor/mineral/titanium/yellow,
/area/shuttle/supply)
"P" = (
/obj/effect/turf_decal/stripes/line{
	dir = 4
	},
/obj/machinery/light/directional/east,
/obj/effect/turf_decal/tile/brown/opposingcorners,
/turf/open/floor/mineral/titanium/yellow,
/area/shuttle/supply)
"Q" = (
/obj/effect/turf_decal/stripes/corner,
/obj/effect/turf_decal/tile/brown/opposingcorners,
/turf/open/floor/mineral/titanium/yellow,
/area/shuttle/supply)
"R" = (
/obj/effect/turf_decal/stripes/corner{
	dir = 8
	},
/obj/effect/turf_decal/tile/brown/opposingcorners,
/turf/open/floor/mineral/titanium/yellow,
/area/shuttle/supply)
"S" = (
/obj/effect/turf_decal/stripes/line{
	dir = 9
	},
/obj/effect/turf_decal/tile/brown/opposingcorners,
/turf/open/floor/mineral/titanium/yellow,
/area/shuttle/supply)
"U" = (
/obj/effect/turf_decal/stripes/line{
	dir = 1
	},
/obj/effect/turf_decal/tile/brown/opposingcorners,
/turf/open/floor/mineral/titanium/yellow,
/area/shuttle/supply)
"V" = (
/obj/effect/turf_decal/stripes/corner{
	dir = 1
	},
/obj/effect/turf_decal/tile/brown/opposingcorners,
/turf/open/floor/mineral/titanium/yellow,
/area/shuttle/supply)
"W" = (
/obj/effect/turf_decal/stripes/end{
	dir = 8
	},
/obj/effect/turf_decal/tile/brown/opposingcorners,
/turf/open/floor/mineral/titanium/yellow,
/area/shuttle/supply)
"X" = (
/obj/effect/turf_decal/stripes/line{
	dir = 5
	},
/obj/effect/turf_decal/tile/brown/opposingcorners,
/turf/open/floor/mineral/titanium/yellow,
/area/shuttle/supply)
"Z" = (
/obj/effect/turf_decal/stripes/line{
	dir = 10
	},
/obj/effect/turf_decal/tile/brown/opposingcorners,
/turf/open/floor/mineral/titanium/yellow,
/area/shuttle/supply)

(1,1,1) = {"
a
a
a
i
m
a
r
t
a
a
a
B
"}
(2,1,1) = {"
a
S
Z
j
O
I
L
u
W
y
a
C
"}
(3,1,1) = {"
a
U
R
K
V
G
R
K
K
Z
A
D
"}
(4,1,1) = {"
a
U
G
G
G
G
G
G
G
N
A
D
"}
(5,1,1) = {"
a
U
G
G
G
G
G
G
Q
F
A
D
"}
(6,1,1) = {"
a
X
J
P
J
M
J
P
F
y
a
E
"}
(7,1,1) = {"
a
a
a
a
a
a
a
a
a
a
a
B
"}
