//MAP CONVERTED BY dmm2tgm.py THIS HEADER COMMENT PREVENTS RECONVERSION, DO NOT REMOVE
"ak" = (
/obj/effect/turf_decal/stripes/line,
/obj/effect/turf_decal/tile/red/anticorner/contrasted{
	dir = 8
	},
/turf/open/floor/iron/dark,
/area/centcom/ctf)
"av" = (
/turf/closed/indestructible/riveted,
/area/centcom/ctf)
"aU" = (
/obj/effect/turf_decal/stripes/line{
	dir = 1
	},
/obj/effect/turf_decal/tile/blue/anticorner/contrasted{
	dir = 4
	},
/turf/open/floor/iron/dark,
/area/centcom/ctf)
"aY" = (
/obj/effect/turf_decal/stripes/line,
/turf/open/floor/plating,
/area/centcom/ctf)
"bp" = (
/obj/item/ctf/red,
/turf/open/floor/circuit/green/anim,
/area/centcom/ctf)
"bM" = (
/obj/effect/turf_decal/stripes/line,
/obj/effect/turf_decal/tile/red{
	dir = 1
	},
/turf/open/floor/iron/dark,
/area/centcom/ctf)
"cD" = (
/obj/effect/turf_decal/stripes/line{
	dir = 1
	},
/turf/open/floor/iron/dark,
/area/centcom/ctf)
"cJ" = (
/obj/structure/trap/ctf/red,
/obj/effect/turf_decal/tile/red/fourcorners,
/turf/open/floor/iron/dark,
/area/centcom/ctf)
"cL" = (
/obj/effect/turf_decal/tile/red/fourcorners,
/turf/open/floor/iron/dark,
/area/centcom/ctf)
"cO" = (
/obj/effect/turf_decal/stripes/line{
	dir = 8
	},
/turf/open/floor/plating,
/area/centcom/ctf)
"dm" = (
/turf/open/floor/circuit/green/off,
/area/centcom/ctf)
"dT" = (
/obj/effect/turf_decal/tile/red/anticorner/contrasted{
	dir = 1
	},
/turf/open/floor/iron/dark,
/area/centcom/ctf)
"ev" = (
/obj/structure/window/reinforced/fulltile/indestructible,
/turf/open/floor/plating,
/area/centcom/ctf)
"eG" = (
/obj/effect/turf_decal/stripes/line,
/obj/effect/turf_decal/tile/blue/half/contrasted{
	dir = 8
	},
/turf/open/floor/iron/dark,
/area/centcom/ctf)
"eW" = (
/obj/effect/turf_decal/stripes/line{
	dir = 1
	},
/obj/effect/turf_decal/tile/blue{
	dir = 8
	},
/turf/open/floor/iron/dark,
/area/centcom/ctf)
"fV" = (
/obj/effect/turf_decal/stripes/line{
	dir = 1
	},
/obj/effect/turf_decal/tile/red/half/contrasted{
	dir = 4
	},
/turf/open/floor/iron/dark,
/area/centcom/ctf)
"gn" = (
/obj/effect/turf_decal/stripes/line{
	dir = 10
	},
/obj/effect/turf_decal/tile/blue{
	dir = 4
	},
/turf/open/floor/iron/dark,
/area/centcom/ctf)
"go" = (
/obj/effect/turf_decal/stripes/line,
/obj/effect/turf_decal/tile/red/half/contrasted{
	dir = 8
	},
/turf/open/floor/iron/dark,
/area/centcom/ctf)
"gz" = (
/obj/structure/trap/ctf/blue,
/obj/effect/turf_decal/tile/blue/fourcorners,
/turf/open/floor/iron,
/area/centcom/ctf)
"hf" = (
/obj/effect/turf_decal/stripes/line{
	dir = 8
	},
/turf/open/floor/circuit/red,
/area/centcom/ctf)
"hp" = (
/obj/effect/turf_decal/stripes/line{
	dir = 8
	},
/obj/effect/turf_decal/tile/blue/half/contrasted{
	dir = 1
	},
/turf/open/floor/iron/dark,
/area/centcom/ctf)
"ie" = (
/obj/effect/turf_decal/tile/blue/half/contrasted{
	dir = 8
	},
/turf/open/floor/iron/dark,
/area/centcom/ctf)
"iO" = (
/turf/open/floor/circuit/red,
/area/centcom/ctf)
"iT" = (
/obj/effect/turf_decal/tile/blue/half/contrasted,
/turf/open/floor/iron/dark,
/area/centcom/ctf)
"jf" = (
/obj/effect/turf_decal/stripes/line{
	dir = 5
	},
/turf/open/floor/circuit/red,
/area/centcom/ctf)
"jH" = (
/obj/effect/turf_decal/stripes/line{
	dir = 9
	},
/obj/effect/turf_decal/tile/blue/anticorner/contrasted{
	dir = 1
	},
/turf/open/floor/iron/dark,
/area/centcom/ctf)
"kD" = (
/obj/effect/turf_decal/stripes/line{
	dir = 6
	},
/turf/open/floor/circuit,
/area/centcom/ctf)
"md" = (
/obj/effect/turf_decal/tile/red/half/contrasted{
	dir = 4
	},
/turf/open/floor/iron/dark,
/area/centcom/ctf)
"mD" = (
/obj/effect/turf_decal/stripes/line{
	dir = 4
	},
/obj/effect/turf_decal/tile/red{
	dir = 8
	},
/turf/open/floor/iron/dark,
/area/centcom/ctf)
"mX" = (
/obj/structure/fluff/drake_statue,
/turf/open/floor/iron/dark,
/area/centcom/ctf)
"nq" = (
/turf/open/floor/circuit,
/area/centcom/ctf)
"nI" = (
/obj/effect/turf_decal/stripes/line{
	dir = 9
	},
/turf/open/floor/circuit/red,
/area/centcom/ctf)
"oG" = (
/obj/effect/turf_decal/tile/red/half/contrasted{
	dir = 8
	},
/turf/open/floor/iron/dark,
/area/centcom/ctf)
"pb" = (
/obj/effect/turf_decal/stripes/line,
/obj/effect/turf_decal/stripes/line{
	dir = 10
	},
/turf/open/floor/circuit,
/area/centcom/ctf)
"qq" = (
/obj/effect/turf_decal/tile/blue/anticorner/contrasted{
	dir = 1
	},
/turf/open/floor/iron/dark,
/area/centcom/ctf)
"qv" = (
/obj/effect/turf_decal/stripes/line{
	dir = 1
	},
/turf/open/floor/plating,
/area/centcom/ctf)
"qU" = (
/turf/open/floor/plating,
/area/centcom/ctf)
"sv" = (
/obj/effect/turf_decal/stripes/line{
	dir = 5
	},
/obj/effect/turf_decal/tile/red{
	dir = 8
	},
/turf/open/floor/iron/dark,
/area/centcom/ctf)
"sE" = (
/obj/effect/turf_decal/stripes/line{
	dir = 8
	},
/turf/open/floor/iron/dark,
/area/centcom/ctf)
"sS" = (
/obj/effect/turf_decal/stripes/line{
	dir = 4
	},
/turf/open/floor/circuit/red,
/area/centcom/ctf)
"td" = (
/obj/effect/turf_decal/stripes/line{
	dir = 4
	},
/obj/effect/turf_decal/tile/red/half/contrasted,
/turf/open/floor/iron/dark,
/area/centcom/ctf)
"uB" = (
/obj/effect/turf_decal/tile/red/fourcorners,
/turf/open/floor/iron,
/area/centcom/ctf)
"uF" = (
/obj/effect/turf_decal/stripes/line{
	dir = 1
	},
/obj/effect/turf_decal/tile/red/anticorner/contrasted{
	dir = 1
	},
/turf/open/floor/iron/dark,
/area/centcom/ctf)
"vJ" = (
/obj/effect/turf_decal/stripes/line{
	dir = 6
	},
/turf/open/floor/circuit/red,
/area/centcom/ctf)
"vL" = (
/obj/effect/turf_decal/stripes/line{
	dir = 5
	},
/turf/open/floor/circuit,
/area/centcom/ctf)
"vU" = (
/obj/effect/turf_decal/tile/blue/fourcorners,
/turf/open/floor/iron/dark,
/area/centcom/ctf)
"wn" = (
/obj/effect/turf_decal/stripes/line{
	dir = 1
	},
/obj/effect/turf_decal/tile/blue/half/contrasted{
	dir = 4
	},
/turf/open/floor/iron/dark,
/area/centcom/ctf)
"xD" = (
/turf/open/floor/circuit/green/anim,
/area/centcom/ctf)
"yy" = (
/obj/structure/barricade/security/ctf,
/turf/open/floor/circuit/green/off,
/area/centcom/ctf)
"zr" = (
/obj/effect/turf_decal/stripes/line{
	dir = 4
	},
/turf/open/floor/iron/dark,
/area/centcom/ctf)
"zU" = (
/obj/effect/turf_decal/tile/blue/half/contrasted{
	dir = 4
	},
/turf/open/floor/iron/dark,
/area/centcom/ctf)
"Ab" = (
/obj/effect/turf_decal/stripes/line{
	dir = 8
	},
/obj/effect/turf_decal/stripes/line{
	dir = 1
	},
/turf/open/floor/iron/dark,
/area/centcom/ctf)
"Aj" = (
/obj/effect/turf_decal/stripes/line,
/obj/effect/turf_decal/tile/blue/anticorner/contrasted,
/turf/open/floor/iron/dark,
/area/centcom/ctf)
"AI" = (
/obj/structure/barricade/security/ctf,
/turf/open/floor/circuit,
/area/centcom/ctf)
"AJ" = (
/obj/machinery/capture_the_flag/blue,
/turf/open/floor/circuit/green/anim,
/area/centcom/ctf)
"AL" = (
/obj/effect/turf_decal/stripes/line{
	dir = 1
	},
/turf/open/floor/circuit/red,
/area/centcom/ctf)
"Cc" = (
/obj/effect/turf_decal/stripes/line,
/turf/open/floor/circuit,
/area/centcom/ctf)
"CD" = (
/obj/effect/turf_decal/tile/red/half/contrasted{
	dir = 1
	},
/turf/open/floor/iron/dark,
/area/centcom/ctf)
"CK" = (
/obj/effect/turf_decal/tile/red/anticorner/contrasted,
/turf/open/floor/iron/dark,
/area/centcom/ctf)
"DG" = (
/obj/effect/turf_decal/stripes/line{
	dir = 10
	},
/turf/open/floor/iron/dark,
/area/centcom/ctf)
"El" = (
/obj/effect/turf_decal/tile/blue/anticorner/contrasted{
	dir = 4
	},
/turf/open/floor/iron/dark,
/area/centcom/ctf)
"En" = (
/obj/effect/turf_decal/tile/blue/half/contrasted{
	dir = 1
	},
/turf/open/floor/iron/dark,
/area/centcom/ctf)
"EC" = (
/obj/effect/turf_decal/stripes/line,
/obj/effect/turf_decal/tile/blue{
	dir = 4
	},
/turf/open/floor/iron/dark,
/area/centcom/ctf)
"EQ" = (
/obj/effect/turf_decal/stripes/line{
	dir = 1
	},
/turf/open/floor/circuit,
/area/centcom/ctf)
"EV" = (
/obj/effect/turf_decal/tile/red{
	dir = 8
	},
/turf/open/floor/iron/dark,
/area/centcom/ctf)
"Fp" = (
/obj/effect/turf_decal/stripes/line{
	dir = 9
	},
/turf/open/floor/circuit,
/area/centcom/ctf)
"FQ" = (
/obj/effect/turf_decal/tile/red,
/turf/open/floor/iron/dark,
/area/centcom/ctf)
"Ga" = (
/obj/effect/turf_decal/stripes/line{
	dir = 1
	},
/obj/effect/turf_decal/tile/red{
	dir = 8
	},
/turf/open/floor/iron/dark,
/area/centcom/ctf)
"Gd" = (
/obj/effect/turf_decal/stripes/line,
/turf/open/floor/circuit/green/off,
/area/centcom/ctf)
"Gn" = (
/obj/item/ctf/blue,
/turf/open/floor/circuit/green/anim,
/area/centcom/ctf)
"GW" = (
/obj/effect/turf_decal/tile/red{
	dir = 1
	},
/turf/open/floor/iron/dark,
/area/centcom/ctf)
"HA" = (
/obj/structure/trap/ctf/red,
/obj/effect/turf_decal/tile/red/fourcorners,
/turf/open/floor/iron,
/area/centcom/ctf)
"Is" = (
/obj/effect/turf_decal/stripes/line{
	dir = 8
	},
/turf/open/floor/circuit,
/area/centcom/ctf)
"IA" = (
/obj/effect/turf_decal/stripes/line{
	dir = 1
	},
/obj/effect/turf_decal/tile/red,
/turf/open/floor/iron/dark,
/area/centcom/ctf)
"IB" = (
/obj/effect/turf_decal/stripes/line{
	dir = 6
	},
/obj/effect/turf_decal/tile/red/anticorner/contrasted,
/turf/open/floor/iron/dark,
/area/centcom/ctf)
"IJ" = (
/obj/effect/turf_decal/tile/red{
	dir = 4
	},
/turf/open/floor/iron/dark,
/area/centcom/ctf)
"JK" = (
/obj/effect/turf_decal/stripes/line{
	dir = 10
	},
/turf/open/floor/circuit/red,
/area/centcom/ctf)
"Ki" = (
/obj/effect/turf_decal/stripes/line{
	dir = 8
	},
/obj/effect/turf_decal/tile/blue{
	dir = 4
	},
/turf/open/floor/iron/dark,
/area/centcom/ctf)
"LW" = (
/obj/structure/barricade/security/ctf,
/turf/open/floor/iron/bluespace,
/area/centcom/ctf)
"Mb" = (
/obj/effect/turf_decal/tile/blue{
	dir = 4
	},
/turf/open/floor/iron/dark,
/area/centcom/ctf)
"Mz" = (
/obj/structure/barricade/security/ctf,
/turf/open/floor/circuit/red,
/area/centcom/ctf)
"MR" = (
/obj/effect/turf_decal/tile/blue/fourcorners,
/turf/open/floor/iron,
/area/centcom/ctf)
"Nf" = (
/obj/effect/turf_decal/stripes/line{
	dir = 5
	},
/obj/effect/turf_decal/tile/red/anticorner/contrasted{
	dir = 4
	},
/turf/open/floor/iron/dark,
/area/centcom/ctf)
"Nu" = (
/obj/effect/turf_decal/stripes/line{
	dir = 1
	},
/obj/effect/turf_decal/stripes/line{
	dir = 5
	},
/turf/open/floor/iron/dark,
/area/centcom/ctf)
"NC" = (
/obj/effect/turf_decal/stripes/line{
	dir = 4
	},
/obj/effect/turf_decal/tile/red{
	dir = 1
	},
/turf/open/floor/iron/dark,
/area/centcom/ctf)
"NE" = (
/obj/effect/turf_decal/tile/blue{
	dir = 8
	},
/turf/open/floor/iron/dark,
/area/centcom/ctf)
"NX" = (
/obj/effect/turf_decal/tile/blue/anticorner/contrasted,
/turf/open/floor/iron/dark,
/area/centcom/ctf)
"OL" = (
/turf/open/floor/iron/dark,
/area/centcom/ctf)
"Pf" = (
/obj/effect/turf_decal/stripes/line{
	dir = 1
	},
/obj/effect/turf_decal/stripes/line{
	dir = 9
	},
/obj/effect/turf_decal/tile/blue,
/turf/open/floor/iron/dark,
/area/centcom/ctf)
"Pv" = (
/obj/effect/turf_decal/stripes/line{
	dir = 6
	},
/obj/effect/turf_decal/tile/red{
	dir = 1
	},
/turf/open/floor/iron/dark,
/area/centcom/ctf)
"Qm" = (
/obj/machinery/power/emitter/energycannon{
	active = 0;
	dir = 1
	},
/turf/open/floor/plating,
/area/centcom/ctf)
"QJ" = (
/obj/effect/turf_decal/stripes/line{
	dir = 4
	},
/turf/open/floor/plating{
	luminosity = 2
	},
/area/centcom/ctf)
"Rx" = (
/obj/effect/turf_decal/stripes/line,
/turf/open/floor/circuit/red,
/area/centcom/ctf)
"Th" = (
/obj/machinery/capture_the_flag/red,
/turf/open/floor/circuit/green/anim,
/area/centcom/ctf)
"Ty" = (
/obj/effect/turf_decal/stripes/line{
	dir = 10
	},
/obj/effect/turf_decal/tile/blue/anticorner/contrasted{
	dir = 8
	},
/turf/open/floor/iron/dark,
/area/centcom/ctf)
"TB" = (
/obj/structure/fluff/drake_statue,
/turf/open/floor/circuit/red,
/area/centcom/ctf)
"Uz" = (
/obj/effect/turf_decal/stripes/line,
/obj/effect/turf_decal/tile/red{
	dir = 4
	},
/turf/open/floor/iron/dark,
/area/centcom/ctf)
"UO" = (
/obj/effect/turf_decal/tile/red/anticorner/contrasted{
	dir = 4
	},
/turf/open/floor/iron/dark,
/area/centcom/ctf)
"US" = (
/obj/structure/table/reinforced/ctf,
/turf/open/floor/iron/dark,
/area/centcom/ctf)
"UY" = (
/obj/effect/turf_decal/tile/blue{
	dir = 1
	},
/turf/open/floor/iron/dark,
/area/centcom/ctf)
"VV" = (
/obj/effect/turf_decal/tile/blue/anticorner/contrasted{
	dir = 8
	},
/turf/open/floor/iron/dark,
/area/centcom/ctf)
"Wv" = (
/obj/effect/turf_decal/tile/red/anticorner/contrasted{
	dir = 8
	},
/turf/open/floor/iron/dark,
/area/centcom/ctf)
"WN" = (
/obj/effect/turf_decal/stripes/line{
	dir = 4
	},
/turf/open/floor/circuit,
/area/centcom/ctf)
"Xh" = (
/obj/effect/turf_decal/stripes/line,
/turf/open/floor/iron/dark,
/area/centcom/ctf)
"Xw" = (
/obj/effect/turf_decal/stripes/line{
	dir = 8
	},
/obj/effect/turf_decal/tile/blue,
/turf/open/floor/iron/dark,
/area/centcom/ctf)
"XG" = (
/obj/effect/turf_decal/stripes/line{
	dir = 6
	},
/turf/open/floor/iron/dark,
/area/centcom/ctf)
"XT" = (
/obj/effect/turf_decal/stripes/line,
/obj/effect/turf_decal/tile/blue{
	dir = 1
	},
/turf/open/floor/iron/dark,
/area/centcom/ctf)
"XX" = (
/obj/structure/table/reinforced/ctf,
/turf/open/floor/iron/bluespace,
/area/centcom/ctf)
"Ym" = (
/obj/effect/turf_decal/stripes/line{
	dir = 1
	},
/obj/effect/turf_decal/tile/blue,
/turf/open/floor/iron/dark,
/area/centcom/ctf)
"Yt" = (
/obj/effect/turf_decal/stripes/line{
	dir = 1
	},
/turf/open/floor/circuit/green/off,
/area/centcom/ctf)
"Yw" = (
/obj/effect/turf_decal/tile/blue,
/turf/open/floor/iron/dark,
/area/centcom/ctf)
"Za" = (
/turf/open/floor/iron/bluespace,
/area/centcom/ctf)
"ZG" = (
/obj/machinery/power/emitter/energycannon{
	active = 0
	},
/turf/open/floor/plating,
/area/centcom/ctf)
"ZH" = (
/obj/effect/turf_decal/tile/red/half/contrasted,
/turf/open/floor/iron/dark,
/area/centcom/ctf)

(1,1,1) = {"
av
av
av
av
av
av
av
av
av
av
av
av
av
av
av
av
av
av
av
av
av
av
av
av
av
av
av
av
av
av
av
av
av
av
av
av
av
av
av
av
av
av
av
"}
(2,1,1) = {"
av
qq
En
En
En
En
En
En
En
En
En
VV
gz
vU
vU
vU
vU
vU
av
vU
vU
vU
vU
vU
av
vU
vU
vU
vU
vU
gz
qq
En
En
En
En
En
En
En
En
En
VV
av
"}
(3,1,1) = {"
av
zU
AI
OL
OL
OL
OL
OL
OL
OL
AI
ie
av
vU
AI
AI
AI
vU
MR
vU
vU
vU
vU
vU
MR
vU
AI
AI
AI
vU
av
zU
AI
OL
OL
OL
OL
OL
OL
OL
AI
ie
av
"}
(4,1,1) = {"
av
zU
AI
OL
OL
nq
nq
nq
OL
OL
AI
ie
av
vU
AI
vU
vU
vU
MR
vU
vU
xD
vU
vU
MR
vU
vU
vU
AI
vU
av
zU
AI
OL
OL
nq
nq
nq
OL
OL
AI
ie
av
"}
(5,1,1) = {"
av
zU
AI
OL
OL
nq
mX
nq
OL
OL
AI
ie
av
vU
AI
vU
vU
vU
MR
vU
xD
AJ
xD
vU
MR
vU
vU
vU
AI
vU
av
zU
AI
OL
OL
nq
mX
nq
OL
OL
AI
ie
av
"}
(6,1,1) = {"
av
zU
AI
OL
OL
nq
nq
nq
OL
OL
AI
ie
av
vU
AI
vU
vU
vU
MR
vU
vU
xD
vU
vU
MR
vU
vU
vU
AI
vU
av
zU
AI
OL
OL
nq
nq
nq
OL
OL
AI
ie
av
"}
(7,1,1) = {"
av
zU
AI
OL
OL
OL
OL
OL
OL
OL
AI
ie
av
vU
AI
AI
AI
vU
MR
vU
vU
vU
vU
vU
MR
vU
AI
AI
AI
vU
av
zU
AI
OL
OL
OL
OL
OL
OL
OL
AI
ie
av
"}
(8,1,1) = {"
av
El
iT
iT
iT
iT
iT
iT
iT
iT
iT
NX
gz
vU
vU
vU
vU
vU
av
vU
vU
vU
vU
vU
av
vU
vU
vU
vU
vU
gz
El
iT
iT
iT
iT
iT
iT
iT
iT
iT
NX
av
"}
(9,1,1) = {"
av
av
MR
MR
MR
av
av
av
MR
MR
MR
av
av
av
gz
gz
gz
av
av
av
av
av
av
av
av
av
gz
gz
gz
av
av
av
MR
MR
MR
av
av
av
MR
MR
MR
av
av
"}
(10,1,1) = {"
av
qq
En
En
En
VV
av
qq
En
En
En
VV
av
qq
En
En
En
VV
av
vU
vU
vU
vU
vU
av
qq
En
En
En
VV
av
qq
En
En
En
VV
av
qq
En
En
En
VV
av
"}
(11,1,1) = {"
av
zU
vU
vU
vU
ie
MR
zU
vU
vU
vU
ie
MR
zU
vU
AI
vU
ie
av
vU
OL
OL
OL
vU
av
zU
OL
AI
OL
ie
MR
zU
OL
OL
OL
ie
MR
zU
OL
OL
OL
ie
av
"}
(12,1,1) = {"
av
zU
AI
AI
AI
ie
MR
zU
AI
AI
AI
ie
MR
zU
AI
AI
AI
ie
av
vU
av
AI
av
vU
av
zU
AI
AI
AI
ie
MR
zU
AI
AI
AI
ie
MR
zU
AI
AI
AI
ie
av
"}
(13,1,1) = {"
av
zU
vU
AI
vU
ie
MR
zU
vU
AI
vU
ie
MR
zU
vU
AI
vU
ie
av
vU
OL
OL
OL
vU
av
zU
OL
AI
OL
ie
MR
zU
OL
AI
OL
ie
MR
zU
OL
AI
OL
ie
av
"}
(14,1,1) = {"
av
El
iT
iT
iT
NX
av
El
iT
iT
iT
NX
av
El
iT
iT
iT
NX
av
vU
vU
vU
vU
vU
av
El
iT
iT
iT
NX
av
El
iT
iT
iT
NX
av
El
iT
iT
iT
NX
av
"}
(15,1,1) = {"
av
av
MR
MR
MR
av
av
av
MR
MR
MR
av
av
av
av
av
av
av
av
av
vU
vU
vU
av
av
av
av
av
av
av
av
av
MR
MR
MR
av
av
av
MR
MR
MR
av
av
"}
(16,1,1) = {"
av
qq
En
En
En
VV
av
qq
En
En
En
VV
av
vU
vU
vU
vU
vU
av
vU
vU
vU
vU
vU
av
vU
vU
vU
vU
vU
av
qq
En
En
En
VV
av
qq
En
En
En
VV
av
"}
(17,1,1) = {"
av
zU
vU
AI
vU
ie
ev
zU
vU
AI
vU
ie
vU
vU
OL
av
OL
vU
vU
vU
AI
xD
AI
vU
vU
vU
OL
av
OL
vU
vU
zU
OL
AI
OL
ie
ev
zU
OL
AI
OL
ie
av
"}
(18,1,1) = {"
av
zU
AI
AI
AI
ie
ev
zU
AI
AI
AI
ie
vU
vU
OL
AI
OL
vU
vU
vU
xD
Gn
xD
vU
vU
vU
OL
AI
OL
vU
vU
zU
AI
AI
AI
ie
ev
zU
AI
AI
AI
ie
av
"}
(19,1,1) = {"
av
zU
vU
AI
vU
ie
ev
zU
vU
AI
vU
ie
vU
vU
OL
av
OL
vU
vU
vU
AI
xD
AI
vU
vU
vU
OL
av
OL
vU
vU
zU
OL
AI
OL
ie
ev
zU
OL
AI
OL
ie
av
"}
(20,1,1) = {"
av
El
iT
iT
iT
NX
av
El
iT
iT
iT
NX
av
vU
vU
vU
vU
vU
av
vU
vU
vU
vU
vU
av
vU
vU
vU
vU
vU
av
El
iT
iT
iT
NX
av
El
iT
iT
iT
NX
av
"}
(21,1,1) = {"
av
av
MR
MR
MR
av
av
av
MR
MR
MR
av
av
av
av
av
av
av
av
av
vU
vU
vU
av
av
av
av
av
av
av
av
av
MR
MR
MR
av
av
av
MR
MR
MR
av
av
"}
(22,1,1) = {"
av
qq
En
En
En
VV
av
qq
En
En
En
VV
av
av
av
qU
av
av
av
vU
vU
vU
vU
vU
av
av
av
qU
av
av
av
qq
En
En
En
VV
av
qq
En
En
En
VV
av
"}
(23,1,1) = {"
av
zU
vU
AI
vU
ie
MR
zU
vU
AI
vU
ie
av
av
av
qU
av
av
av
vU
OL
OL
OL
vU
av
av
av
qU
av
av
av
zU
OL
AI
OL
ie
MR
zU
OL
AI
OL
ie
av
"}
(24,1,1) = {"
av
zU
AI
AI
AI
ie
MR
zU
AI
AI
AI
ie
qU
qU
qU
qU
qU
qU
av
vU
av
AI
av
vU
av
qU
qU
qU
qU
qU
qU
zU
AI
AI
AI
ie
MR
zU
AI
AI
AI
ie
av
"}
(25,1,1) = {"
av
zU
vU
vU
vU
ie
MR
zU
vU
vU
vU
ie
av
av
av
qU
av
ev
av
vU
OL
OL
OL
vU
av
ev
av
qU
av
av
av
zU
OL
OL
OL
ie
MR
zU
OL
OL
OL
ie
av
"}
(26,1,1) = {"
av
El
iT
iT
iT
NX
av
El
iT
iT
iT
NX
av
av
av
qU
ev
ev
ev
vU
vU
vU
vU
vU
ev
ev
ev
qU
av
av
av
El
iT
iT
iT
NX
av
El
iT
iT
iT
NX
av
"}
(27,1,1) = {"
av
av
XX
XX
XX
av
av
av
zr
zr
zr
av
av
av
av
qU
av
ev
av
av
vU
vU
vU
av
av
ev
av
qU
av
av
av
av
av
cO
av
av
av
av
US
US
US
av
av
"}
(28,1,1) = {"
av
av
XX
XX
XX
OL
Xh
Pf
Ki
sE
Xw
gn
av
av
av
OL
OL
OL
OL
OL
OL
OL
OL
OL
OL
OL
OL
OL
av
av
av
av
av
qU
av
av
av
av
XX
XX
XX
av
av
"}
(29,1,1) = {"
av
av
XX
XX
XX
OL
Xh
eW
vU
iT
vU
XT
cD
OL
OL
OL
OL
OL
OL
OL
OL
OL
OL
OL
OL
OL
OL
OL
OL
OL
ev
ev
ev
qU
av
av
av
av
XX
XX
XX
av
av
"}
(30,1,1) = {"
av
av
XX
XX
XX
OL
Xh
cD
NE
vU
UY
Xh
av
Za
av
OL
OL
OL
av
av
ev
ev
ev
av
av
OL
OL
OL
av
Za
av
av
av
qU
av
av
av
av
XX
XX
XX
av
av
"}
(31,1,1) = {"
av
av
XX
XX
XX
av
av
cD
OL
OL
OL
Xh
av
Za
ev
OL
nq
OL
vU
MR
vU
MR
vU
MR
vU
OL
nq
OL
ev
Za
av
av
av
qU
av
av
av
av
XX
XX
XX
av
av
"}
(32,1,1) = {"
av
av
LW
XX
LW
av
av
Ym
Mb
OL
Yw
EC
av
Za
ev
OL
nq
OL
MR
vU
MR
vU
MR
vU
MR
OL
nq
OL
ev
Za
ev
ZG
aY
qU
qv
Qm
av
av
LW
XX
LW
av
av
"}
(33,1,1) = {"
av
av
LW
XX
LW
av
av
eW
vU
iT
vU
XT
av
Za
ev
OL
nq
OL
vU
MR
vU
MR
vU
MR
vU
OL
nq
OL
ev
Za
av
av
av
qU
av
av
av
av
LW
XX
LW
av
av
"}
(34,1,1) = {"
av
av
XX
XX
XX
av
av
cD
NE
vU
UY
Xh
av
Za
av
OL
nq
OL
av
AI
nq
nq
nq
AI
av
OL
nq
OL
av
Za
ev
ev
ev
qU
av
av
av
av
XX
XX
XX
av
av
"}
(35,1,1) = {"
av
av
XX
XX
XX
OL
Xh
cD
OL
OL
OL
Xh
AI
Za
AI
OL
nq
OL
ev
nq
nq
nq
nq
nq
ev
OL
nq
OL
AI
Za
av
av
av
qU
av
av
av
av
XX
XX
XX
av
av
"}
(36,1,1) = {"
av
av
XX
XX
XX
OL
Xh
Ym
Mb
OL
Yw
EC
AI
Za
AI
OL
nq
OL
ev
nq
nq
AI
nq
nq
ev
OL
nq
OL
AI
Za
ev
ZG
aY
qU
qv
Qm
av
av
XX
XX
XX
av
av
"}
(37,1,1) = {"
av
av
XX
XX
XX
OL
Xh
eW
vU
iT
vU
XT
AI
Za
AI
OL
nq
OL
ev
nq
nq
nq
nq
nq
ev
OL
nq
OL
AI
Za
av
av
av
qU
av
av
av
av
XX
XX
XX
av
av
"}
(38,1,1) = {"
av
av
XX
XX
XX
av
av
cD
NE
vU
UY
Xh
av
Za
av
OL
nq
OL
av
AI
nq
nq
nq
AI
av
OL
nq
OL
av
Za
ev
ev
ev
qU
av
av
av
av
XX
XX
XX
av
av
"}
(39,1,1) = {"
av
av
XX
XX
XX
av
av
cD
OL
OL
OL
Xh
av
Za
ev
OL
nq
OL
vU
MR
vU
MR
vU
MR
vU
OL
nq
OL
ev
Za
av
av
av
qU
av
av
av
av
XX
XX
XX
av
av
"}
(40,1,1) = {"
av
av
Za
XX
Za
av
av
Ym
Mb
OL
Yw
EC
av
Za
ev
OL
nq
OL
MR
vU
MR
vU
MR
vU
MR
OL
nq
OL
ev
Za
ev
ZG
aY
qU
qv
Qm
av
av
Za
XX
Za
av
av
"}
(41,1,1) = {"
av
av
XX
XX
XX
av
av
eW
vU
iT
vU
XT
av
Za
ev
OL
nq
OL
vU
MR
vU
MR
vU
MR
vU
OL
nq
OL
ev
Za
av
av
av
qU
av
av
av
av
XX
XX
XX
av
av
"}
(42,1,1) = {"
av
av
XX
XX
XX
av
av
cD
NE
vU
UY
Xh
av
Za
av
OL
OL
OL
av
av
av
av
av
av
av
OL
OL
OL
av
Za
av
av
av
qU
av
av
av
av
XX
XX
XX
av
av
"}
(43,1,1) = {"
av
av
XX
XX
XX
av
av
cD
OL
OL
OL
Xh
Fp
Is
pb
jH
hp
hp
hp
hp
hp
hp
hp
hp
hp
hp
hp
Ty
OL
OL
ev
ev
ev
qU
av
av
av
av
XX
XX
XX
av
av
"}
(44,1,1) = {"
av
av
XX
XX
XX
av
av
Ym
Mb
OL
Yw
EC
EQ
nq
Cc
wn
vU
vU
vU
vU
vU
vU
vU
vU
vU
vU
vU
eG
av
av
av
av
av
qU
av
av
av
av
XX
XX
XX
av
av
"}
(45,1,1) = {"
av
av
XX
LW
XX
av
av
eW
AI
AI
AI
XT
EQ
nq
Cc
wn
vU
AI
vU
av
AI
AI
AI
av
vU
AI
vU
eG
av
av
av
ZG
aY
qU
qv
Qm
av
av
XX
LW
XX
av
av
"}
(46,1,1) = {"
av
av
XX
XX
XX
av
av
cD
NE
vU
UY
Xh
EQ
nq
Cc
wn
vU
vU
vU
vU
vU
vU
vU
vU
vU
vU
vU
eG
av
av
av
av
av
qU
av
av
av
av
XX
XX
XX
av
av
"}
(47,1,1) = {"
av
av
XX
XX
XX
av
av
Nu
zr
zr
zr
XG
vL
WN
kD
aU
iT
iT
iT
iT
iT
iT
iT
iT
iT
iT
iT
Aj
OL
OL
ev
ev
ev
qU
av
av
av
av
XX
XX
XX
av
av
"}
(48,1,1) = {"
av
av
XX
XX
XX
av
av
av
av
cO
av
av
av
Za
av
Yt
dm
dm
av
av
av
av
av
av
av
dm
dm
Gd
av
Za
av
av
av
qU
av
av
av
av
XX
XX
XX
av
av
"}
(49,1,1) = {"
av
av
XX
XX
XX
av
av
av
av
qU
av
av
av
Za
ev
Yt
dm
dm
dm
dm
nq
AI
nq
dm
dm
dm
dm
Gd
ev
Za
av
av
av
qU
av
av
av
av
XX
XX
XX
av
av
"}
(50,1,1) = {"
av
av
Za
XX
Za
av
av
ZG
aY
qU
qv
Qm
ev
Za
ev
Yt
dm
dm
nq
dm
dm
nq
dm
dm
nq
dm
dm
Gd
ev
Za
ev
ZG
aY
qU
qv
Qm
av
av
Za
XX
Za
av
av
"}
(51,1,1) = {"
av
av
XX
XX
XX
av
av
av
av
qU
av
av
av
Za
ev
Yt
dm
dm
AI
nq
dm
dm
dm
nq
AI
dm
dm
Gd
ev
Za
av
av
av
qU
av
av
av
av
XX
XX
XX
av
av
"}
(52,1,1) = {"
av
av
XX
XX
XX
av
av
av
av
qU
ev
ev
ev
Za
av
Yt
dm
dm
dm
AI
nq
dm
nq
AI
dm
dm
dm
Gd
av
Za
ev
ev
ev
qU
av
av
av
av
XX
XX
XX
av
av
"}
(53,1,1) = {"
av
av
XX
XX
XX
av
av
av
av
qU
av
av
av
Za
yy
Yt
av
dm
dm
dm
AI
nq
AI
dm
dm
dm
av
Gd
yy
Za
av
av
av
qU
av
av
av
av
XX
XX
XX
av
av
"}
(54,1,1) = {"
av
av
XX
LW
XX
av
av
ZG
aY
qU
qv
Qm
ev
Za
yy
Yt
dm
av
dm
dm
dm
dm
dm
dm
dm
av
dm
Gd
yy
Za
ev
ZG
aY
qU
qv
Qm
av
av
XX
LW
XX
av
av
"}
(55,1,1) = {"
av
av
XX
XX
XX
av
av
av
av
qU
av
av
av
Za
yy
Yt
av
dm
dm
dm
Mz
iO
Mz
dm
dm
dm
av
Gd
yy
Za
av
av
av
qU
av
av
av
av
XX
XX
XX
av
av
"}
(56,1,1) = {"
av
av
XX
XX
XX
av
av
av
av
qU
ev
ev
ev
Za
av
Yt
dm
dm
dm
Mz
iO
dm
iO
Mz
dm
dm
dm
Gd
av
Za
ev
ev
ev
qU
av
av
av
av
XX
XX
XX
av
av
"}
(57,1,1) = {"
av
av
XX
XX
XX
av
av
av
av
qU
av
av
av
Za
ev
Yt
dm
dm
Mz
iO
dm
dm
dm
iO
Mz
dm
dm
Gd
ev
Za
av
av
av
qU
av
av
av
av
XX
XX
XX
av
av
"}
(58,1,1) = {"
av
av
Za
XX
Za
av
av
ZG
aY
qU
qv
Qm
ev
Za
ev
Yt
dm
dm
iO
dm
dm
iO
dm
dm
iO
dm
dm
Gd
ev
Za
ev
ZG
aY
qU
qv
Qm
av
av
Za
XX
Za
av
av
"}
(59,1,1) = {"
av
av
XX
XX
XX
av
av
av
av
qU
av
av
av
Za
ev
Yt
dm
dm
dm
dm
iO
Mz
iO
dm
dm
dm
dm
Gd
ev
Za
av
av
av
qU
av
av
av
av
XX
XX
XX
av
av
"}
(60,1,1) = {"
av
av
XX
XX
XX
av
av
av
av
qU
av
av
av
Za
av
Yt
dm
dm
av
av
av
av
av
av
av
dm
dm
Gd
av
Za
av
av
av
QJ
av
av
av
av
XX
XX
XX
av
av
"}
(61,1,1) = {"
av
av
XX
XX
XX
av
av
av
av
qU
ev
ev
ev
OL
OL
uF
CD
CD
CD
CD
CD
CD
CD
CD
CD
CD
CD
ak
nI
hf
JK
Ab
sE
sE
sE
DG
av
av
XX
XX
XX
av
av
"}
(62,1,1) = {"
av
av
XX
XX
XX
av
av
av
av
qU
av
av
av
av
av
fV
cL
cL
cL
cL
cL
cL
cL
cL
cL
cL
cL
go
AL
iO
Rx
cD
FQ
cL
IJ
Xh
av
av
XX
XX
XX
av
av
"}
(63,1,1) = {"
av
av
XX
LW
XX
av
av
ZG
aY
qU
qv
Qm
ev
av
av
fV
cL
Mz
cL
av
Mz
Mz
Mz
av
cL
Mz
cL
go
AL
iO
Rx
IA
Mz
Mz
Mz
Uz
av
av
XX
LW
XX
av
av
"}
(64,1,1) = {"
av
av
XX
XX
XX
av
av
av
av
qU
av
av
av
av
av
fV
cL
cL
cL
cL
cL
cL
cL
cL
cL
cL
cL
go
AL
iO
Rx
Ga
GW
OL
EV
bM
av
av
XX
XX
XX
av
av
"}
(65,1,1) = {"
av
av
XX
XX
XX
av
av
av
av
qU
ev
ev
ev
OL
OL
Nf
td
td
td
td
td
td
td
td
td
td
td
IB
jf
sS
vJ
cD
OL
OL
OL
Xh
av
av
XX
XX
XX
av
av
"}
(66,1,1) = {"
av
av
XX
XX
XX
av
av
av
av
qU
av
av
av
Za
av
OL
OL
OL
av
av
av
av
av
av
av
OL
OL
OL
av
Za
av
cD
FQ
cL
IJ
Xh
av
av
XX
XX
XX
av
av
"}
(67,1,1) = {"
av
av
XX
XX
XX
av
av
av
av
qU
av
av
av
Za
ev
OL
iO
OL
cL
uB
cL
uB
cL
uB
cL
OL
iO
OL
ev
Za
av
IA
cL
CD
cL
Uz
av
av
XX
XX
XX
av
av
"}
(68,1,1) = {"
av
av
Za
XX
Za
av
av
ZG
aY
qU
qv
Qm
ev
Za
ev
OL
iO
OL
uB
cL
uB
cL
uB
cL
uB
OL
iO
OL
ev
Za
av
Ga
GW
OL
EV
bM
av
av
Za
XX
Za
av
av
"}
(69,1,1) = {"
av
av
XX
XX
XX
av
av
av
av
qU
av
av
av
Za
ev
OL
iO
OL
cL
uB
cL
uB
cL
uB
cL
OL
iO
OL
ev
Za
av
cD
OL
OL
OL
Xh
av
av
XX
XX
XX
av
av
"}
(70,1,1) = {"
av
av
XX
XX
XX
av
av
av
av
qU
ev
ev
ev
Za
av
OL
iO
OL
av
Mz
iO
iO
iO
Mz
av
OL
iO
OL
av
Za
av
cD
FQ
cL
IJ
Xh
av
av
XX
XX
XX
av
av
"}
(71,1,1) = {"
av
av
XX
XX
XX
av
av
av
av
qU
av
av
av
Za
Mz
OL
iO
OL
ev
iO
iO
iO
iO
iO
ev
OL
iO
OL
Mz
Za
Mz
IA
cL
CD
cL
Uz
cD
OL
XX
XX
XX
av
av
"}
(72,1,1) = {"
av
av
XX
XX
XX
av
av
ZG
aY
qU
qv
Qm
ev
Za
Mz
OL
iO
OL
ev
iO
iO
Mz
iO
iO
ev
OL
iO
OL
Mz
Za
Mz
Ga
GW
OL
EV
bM
cD
OL
XX
XX
XX
av
av
"}
(73,1,1) = {"
av
av
XX
XX
XX
av
av
av
av
qU
av
av
av
Za
Mz
OL
iO
OL
ev
iO
iO
iO
iO
iO
ev
OL
iO
OL
Mz
Za
Mz
cD
OL
OL
OL
Xh
cD
OL
XX
XX
XX
av
av
"}
(74,1,1) = {"
av
av
XX
XX
XX
av
av
av
av
qU
ev
ev
ev
Za
av
OL
iO
OL
av
Mz
iO
iO
iO
Mz
av
OL
iO
OL
av
Za
av
cD
FQ
cL
IJ
Xh
av
av
XX
XX
XX
av
av
"}
(75,1,1) = {"
av
av
LW
XX
LW
av
av
av
av
qU
av
av
av
Za
ev
OL
iO
OL
cL
uB
cL
uB
cL
uB
cL
OL
iO
OL
ev
Za
av
IA
cL
CD
cL
Uz
av
av
LW
XX
LW
av
av
"}
(76,1,1) = {"
av
av
LW
XX
LW
av
av
ZG
aY
qU
qv
Qm
ev
Za
ev
OL
iO
OL
uB
cL
uB
cL
uB
cL
uB
OL
iO
OL
ev
Za
av
Ga
GW
OL
EV
bM
av
av
LW
XX
LW
av
av
"}
(77,1,1) = {"
av
av
XX
XX
XX
av
av
av
av
qU
av
av
av
Za
ev
OL
iO
OL
cL
uB
cL
uB
cL
uB
cL
OL
iO
OL
ev
Za
av
cD
OL
OL
OL
Xh
av
av
XX
XX
XX
av
av
"}
(78,1,1) = {"
av
av
XX
XX
XX
av
av
av
av
qU
av
av
av
Za
av
OL
OL
OL
av
av
ev
ev
ev
av
av
OL
OL
OL
av
Za
av
cD
FQ
cL
IJ
Xh
cD
OL
XX
XX
XX
av
av
"}
(79,1,1) = {"
av
av
XX
XX
XX
av
av
av
av
qU
ev
ev
ev
OL
OL
OL
OL
OL
OL
OL
OL
OL
OL
OL
OL
OL
OL
OL
OL
OL
Xh
IA
cL
CD
cL
Uz
cD
OL
XX
XX
XX
av
av
"}
(80,1,1) = {"
av
av
XX
XX
XX
av
av
av
av
qU
av
av
av
av
av
OL
OL
OL
OL
OL
OL
OL
OL
OL
OL
OL
OL
OL
av
av
av
sv
NC
zr
mD
Pv
cD
OL
XX
XX
XX
av
av
"}
(81,1,1) = {"
av
av
XX
XX
XX
av
av
av
av
QJ
av
av
av
av
av
qU
av
ev
av
av
cL
cL
cL
av
av
ev
av
qU
av
av
av
av
sE
sE
sE
av
av
av
XX
XX
XX
av
av
"}
(82,1,1) = {"
av
dT
CD
CD
CD
Wv
av
dT
CD
CD
CD
Wv
av
av
av
qU
ev
ev
ev
cL
cL
cL
cL
cL
ev
ev
ev
qU
av
av
av
dT
CD
CD
CD
Wv
av
dT
CD
CD
CD
Wv
av
"}
(83,1,1) = {"
av
md
OL
OL
OL
oG
uB
md
OL
OL
OL
oG
av
av
av
qU
av
ev
av
cL
OL
OL
OL
cL
av
ev
av
qU
av
av
av
md
OL
OL
OL
oG
uB
md
OL
OL
OL
oG
av
"}
(84,1,1) = {"
av
md
Mz
Mz
Mz
oG
uB
md
Mz
Mz
Mz
oG
qU
qU
qU
qU
qU
qU
av
cL
av
Mz
av
cL
av
qU
qU
qU
qU
qU
qU
md
Mz
Mz
Mz
oG
uB
md
Mz
Mz
Mz
oG
av
"}
(85,1,1) = {"
av
md
OL
Mz
OL
oG
uB
md
OL
Mz
OL
oG
av
av
av
qU
av
av
av
cL
OL
OL
OL
cL
av
av
av
qU
av
av
av
md
OL
Mz
OL
oG
uB
md
OL
Mz
OL
oG
av
"}
(86,1,1) = {"
av
UO
ZH
ZH
ZH
CK
av
UO
ZH
ZH
ZH
CK
av
av
av
qU
av
av
av
cL
cL
cL
cL
cL
av
av
av
qU
av
av
av
UO
ZH
ZH
ZH
CK
av
UO
ZH
ZH
ZH
CK
av
"}
(87,1,1) = {"
av
av
uB
uB
uB
av
av
av
uB
uB
uB
av
av
av
av
av
av
av
av
av
cL
cL
cL
av
av
av
av
av
av
av
av
av
uB
uB
uB
av
av
av
uB
uB
uB
av
av
"}
(88,1,1) = {"
av
dT
CD
CD
CD
Wv
av
dT
CD
CD
CD
Wv
av
cL
cL
cL
cL
cL
av
cL
cL
cL
cL
cL
av
cL
cL
cL
cL
cL
av
dT
CD
CD
CD
Wv
av
dT
CD
CD
CD
Wv
av
"}
(89,1,1) = {"
av
md
OL
Mz
OL
oG
ev
md
OL
Mz
OL
oG
cL
cL
OL
av
OL
cL
cL
cL
Mz
xD
Mz
cL
cL
cL
OL
av
OL
cL
cL
md
OL
Mz
OL
oG
ev
md
OL
Mz
OL
oG
av
"}
(90,1,1) = {"
av
md
Mz
Mz
Mz
oG
ev
md
Mz
Mz
Mz
oG
cL
cL
OL
Mz
OL
cL
cL
cL
xD
bp
xD
cL
cL
cL
OL
Mz
OL
cL
cL
md
Mz
Mz
Mz
oG
ev
md
Mz
Mz
Mz
oG
av
"}
(91,1,1) = {"
av
md
OL
Mz
OL
oG
ev
md
OL
Mz
OL
oG
cL
cL
OL
av
OL
cL
cL
cL
Mz
xD
Mz
cL
cL
cL
OL
av
OL
cL
cL
md
OL
Mz
OL
oG
ev
md
OL
Mz
OL
oG
av
"}
(92,1,1) = {"
av
UO
ZH
ZH
ZH
CK
av
UO
ZH
ZH
ZH
CK
av
cL
cL
cL
cL
cL
av
cL
cL
cL
cL
cL
av
cL
cL
cL
cL
cL
av
UO
ZH
ZH
ZH
CK
av
UO
ZH
ZH
ZH
CK
av
"}
(93,1,1) = {"
av
av
uB
uB
uB
av
av
av
uB
uB
uB
av
av
av
av
av
av
av
av
av
cL
cL
cL
av
av
av
av
av
av
av
av
av
uB
uB
uB
av
av
av
uB
uB
uB
av
av
"}
(94,1,1) = {"
av
dT
CD
CD
CD
Wv
av
dT
CD
CD
CD
Wv
av
dT
CD
CD
CD
Wv
av
cL
cL
cL
cL
cL
av
dT
CD
CD
CD
Wv
av
dT
CD
CD
CD
Wv
av
dT
CD
CD
CD
Wv
av
"}
(95,1,1) = {"
av
md
OL
Mz
OL
oG
uB
md
OL
Mz
OL
oG
uB
md
OL
Mz
OL
oG
av
cL
OL
OL
OL
cL
av
md
cL
Mz
cL
oG
uB
md
OL
Mz
OL
oG
uB
md
OL
Mz
OL
oG
av
"}
(96,1,1) = {"
av
md
Mz
Mz
Mz
oG
uB
md
Mz
Mz
Mz
oG
uB
md
Mz
Mz
Mz
oG
av
cL
av
Mz
av
cL
av
md
Mz
Mz
Mz
oG
uB
md
Mz
Mz
Mz
oG
uB
md
Mz
Mz
Mz
oG
av
"}
(97,1,1) = {"
av
md
OL
OL
OL
oG
uB
md
OL
OL
OL
oG
uB
md
OL
Mz
OL
oG
av
cL
OL
OL
OL
cL
av
md
cL
Mz
cL
oG
uB
md
OL
OL
OL
oG
uB
md
OL
OL
OL
oG
av
"}
(98,1,1) = {"
av
UO
ZH
ZH
ZH
CK
av
UO
ZH
ZH
ZH
CK
av
UO
ZH
ZH
ZH
CK
av
cL
cL
cL
cL
cL
av
UO
ZH
ZH
ZH
CK
av
UO
ZH
ZH
ZH
CK
av
UO
ZH
ZH
ZH
CK
av
"}
(99,1,1) = {"
av
av
uB
uB
uB
av
av
av
uB
uB
uB
av
av
av
HA
HA
HA
av
av
av
av
av
av
av
av
av
HA
HA
HA
av
av
av
uB
uB
uB
av
av
av
uB
uB
uB
av
av
"}
(100,1,1) = {"
av
dT
CD
CD
CD
CD
CD
CD
CD
CD
CD
Wv
cJ
cL
cL
cL
cL
cL
av
cL
cL
cL
cL
cL
av
cL
cL
cL
cL
cL
cJ
dT
CD
CD
CD
CD
CD
CD
CD
CD
CD
Wv
av
"}
(101,1,1) = {"
av
md
Mz
OL
OL
OL
OL
OL
OL
OL
Mz
oG
av
cL
Mz
Mz
Mz
cL
cL
cL
cL
cL
cL
cL
cL
cL
Mz
Mz
Mz
cL
av
md
Mz
OL
OL
OL
OL
OL
OL
OL
Mz
oG
av
"}
(102,1,1) = {"
av
md
Mz
OL
OL
iO
iO
iO
OL
OL
Mz
oG
av
cL
Mz
cL
cL
cL
cL
cL
cL
xD
cL
cL
cL
cL
cL
cL
Mz
cL
av
md
Mz
OL
OL
iO
iO
iO
OL
OL
Mz
oG
av
"}
(103,1,1) = {"
av
md
Mz
OL
OL
iO
TB
iO
OL
OL
Mz
oG
av
cL
Mz
cL
cL
cL
cL
cL
xD
Th
xD
cL
cL
cL
cL
cL
Mz
cL
av
md
Mz
OL
OL
iO
TB
iO
OL
OL
Mz
oG
av
"}
(104,1,1) = {"
av
md
Mz
OL
OL
iO
iO
iO
OL
OL
Mz
oG
av
cL
Mz
cL
cL
cL
cL
cL
cL
xD
cL
cL
cL
cL
cL
cL
Mz
cL
av
md
Mz
OL
OL
iO
iO
iO
OL
OL
Mz
oG
av
"}
(105,1,1) = {"
av
md
Mz
OL
OL
OL
OL
OL
OL
OL
Mz
oG
av
cL
Mz
Mz
Mz
cL
cL
cL
cL
cL
cL
cL
cL
cL
Mz
Mz
Mz
cL
av
md
Mz
OL
OL
OL
OL
OL
OL
OL
Mz
oG
av
"}
(106,1,1) = {"
av
UO
ZH
ZH
ZH
ZH
ZH
ZH
ZH
ZH
ZH
CK
cJ
cL
cL
cL
cL
cL
av
cL
cL
cL
cL
cL
av
cL
cL
cL
cL
cL
cJ
UO
ZH
ZH
ZH
ZH
ZH
ZH
ZH
ZH
ZH
CK
av
"}
(107,1,1) = {"
av
av
av
av
av
av
av
av
av
av
av
av
av
av
av
av
av
av
av
av
av
av
av
av
av
av
av
av
av
av
av
av
av
av
av
av
av
av
av
av
av
av
av
"}
