//MAP CONVERTED BY dmm2tgm.py THIS HEADER COMMENT PREVENTS RECONVERSION, DO NOT REMOVE
"d" = (
/obj/structure/window/reinforced{
	dir = 8
	},
/obj/effect/turf_decal/tile/red/half/contrasted{
	dir = 1
	},
/turf/open/floor/holofloor,
/area/template_noop)
"e" = (
/obj/effect/turf_decal/tile/red/half/contrasted,
/turf/open/floor/holofloor,
/area/template_noop)
"f" = (
/obj/effect/turf_decal/tile/green/half/contrasted,
/turf/open/floor/holofloor,
/area/template_noop)
"g" = (
/obj/effect/turf_decal/tile/green/anticorner/contrasted,
/turf/open/floor/holofloor,
/area/template_noop)
"h" = (
/obj/structure/table/reinforced,
/obj/structure/window/reinforced{
	dir = 4
	},
/obj/structure/window/reinforced{
	dir = 1
	},
/obj/item/training_toolbox{
	pixel_y = 4
	},
/obj/item/training_toolbox,
/obj/effect/turf_decal/tile/red/half/contrasted,
/turf/open/floor/holofloor,
/area/template_noop)
"k" = (
/obj/structure/window/reinforced{
	dir = 1
	},
/obj/structure/window/reinforced{
	dir = 8
	},
/turf/open/floor/holofloor{
	icon_state = "white"
	},
/area/template_noop)
"l" = (
/obj/item/target,
/obj/item/target/syndicate,
/obj/effect/turf_decal/tile/green/half/contrasted{
	dir = 8
	},
/turf/open/floor/holofloor,
/area/template_noop)
"q" = (
/obj/structure/rack,
/obj/item/gun/energy/laser/practice,
/obj/item/clothing/ears/earmuffs,
/obj/effect/turf_decal/tile/green/half/contrasted{
	dir = 8
	},
/turf/open/floor/holofloor,
/area/template_noop)
"r" = (
/obj/item/target,
/obj/item/target/clown,
/obj/effect/turf_decal/tile/green/half/contrasted{
	dir = 8
	},
/turf/open/floor/holofloor,
/area/template_noop)
"t" = (
/obj/structure/window/reinforced{
	dir = 1
	},
/obj/structure/window/reinforced{
	dir = 4
	},
/turf/open/floor/holofloor{
	icon_state = "white"
	},
/area/template_noop)
"u" = (
/obj/effect/turf_decal/tile/green/anticorner/contrasted{
	dir = 8
	},
/turf/open/floor/holofloor,
/area/template_noop)
"w" = (
/obj/structure/window/reinforced{
	dir = 4
	},
/obj/effect/turf_decal/tile/red/half/contrasted,
/turf/open/floor/holofloor,
/area/template_noop)
"y" = (
/obj/structure/window/reinforced{
	dir = 8
	},
/turf/open/floor/holofloor{
	dir = 8;
	icon_state = "white"
	},
/area/template_noop)
"z" = (
/obj/effect/turf_decal/tile/red{
	dir = 1
	},
/turf/open/floor/holofloor,
/area/template_noop)
"B" = (
/obj/effect/turf_decal/tile/green/half/contrasted{
	dir = 8
	},
/turf/open/floor/holofloor,
/area/template_noop)
"C" = (
/obj/effect/turf_decal/tile/red/half/contrasted{
	dir = 1
	},
/turf/open/floor/holofloor,
/area/template_noop)
"F" = (
/obj/structure/window/reinforced{
	dir = 8
	},
/turf/open/floor/holofloor{
	dir = 10;
	icon_state = "white"
	},
/area/template_noop)
"K" = (
/turf/open/floor/holofloor{
	icon_state = "white"
	},
/area/template_noop)
"M" = (
/obj/effect/turf_decal/tile/red/half/contrasted{
	dir = 4
	},
/turf/open/floor/holofloor,
/area/template_noop)
"Q" = (
/turf/open/floor/holofloor,
/area/template_noop)
"R" = (
/obj/structure/table/reinforced,
/obj/machinery/recharger,
/obj/structure/window/reinforced{
	dir = 8
	},
/obj/structure/window/reinforced{
	dir = 1
	},
/obj/effect/turf_decal/tile/red/half/contrasted{
	dir = 1
	},
/turf/open/floor/holofloor,
/area/template_noop)
"S" = (
/obj/structure/training_machine,
/turf/open/floor/holofloor{
	icon_state = "white"
	},
/area/template_noop)
"T" = (
/obj/effect/turf_decal/tile/red{
	dir = 4
	},
/turf/open/floor/holofloor,
/area/template_noop)
"U" = (
/obj/structure/window/reinforced{
	dir = 4
	},
/turf/open/floor/holofloor{
	icon_state = "white"
	},
/area/template_noop)
"V" = (
/obj/effect/turf_decal/tile/green/half/contrasted{
	dir = 1
	},
/turf/open/floor/holofloor,
/area/template_noop)
"Y" = (
/obj/structure/window/reinforced{
	dir = 1
	},
/turf/open/floor/holofloor{
	icon_state = "white"
	},
/area/template_noop)

(1,1,1) = {"
V
V
V
V
V
V
V
V
V
u
"}
(2,1,1) = {"
Q
Q
Q
Q
Q
Q
Q
Q
Q
B
"}
(3,1,1) = {"
e
e
e
e
e
e
e
e
T
r
"}
(4,1,1) = {"
k
y
F
d
d
d
d
R
M
q
"}
(5,1,1) = {"
Y
S
K
Q
Q
Q
Q
Q
M
q
"}
(6,1,1) = {"
t
U
U
w
w
w
w
h
M
q
"}
(7,1,1) = {"
C
C
C
C
C
C
C
C
z
l
"}
(8,1,1) = {"
Q
Q
Q
Q
Q
Q
Q
Q
Q
B
"}
(9,1,1) = {"
f
f
f
f
f
f
f
f
f
g
"}
