//MAP CONVERTED BY dmm2tgm.py THIS HEADER COMMENT PREVENTS RECONVERSION, DO NOT REMOVE
"ab" = (
/obj/structure/window,
/obj/effect/turf_decal/tile/blue/anticorner/contrasted{
	dir = 8
	},
/turf/open/floor/holofloor{
	icon_state = "white"
	},
/area/template_noop)
"ar" = (
/obj/structure/table,
/obj/item/reagent_containers/cup/beaker/large,
/obj/effect/turf_decal/tile/yellow/half/contrasted{
	dir = 1
	},
/turf/open/floor/holofloor{
	icon_state = "white"
	},
/area/template_noop)
"bU" = (
/obj/effect/turf_decal/tile/green/anticorner/contrasted{
	dir = 4
	},
/turf/open/floor/holofloor{
	icon_state = "white"
	},
/area/template_noop)
"bZ" = (
/obj/structure/table/glass,
/obj/item/retractor,
/obj/effect/turf_decal/tile/red/half/contrasted{
	dir = 4
	},
/turf/open/floor/holofloor{
	icon_state = "white"
	},
/area/template_noop)
"cx" = (
/obj/structure/window{
	dir = 4
	},
/obj/effect/turf_decal/tile/red/half/contrasted,
/turf/open/floor/holofloor{
	icon_state = "white"
	},
/area/template_noop)
"cL" = (
/obj/structure/table/glass,
/obj/item/surgical_drapes,
/obj/item/razor,
/obj/item/hemostat,
/obj/effect/turf_decal/tile/red/half/contrasted{
	dir = 4
	},
/turf/open/floor/holofloor{
	icon_state = "white"
	},
/area/template_noop)
"eG" = (
/obj/structure/window{
	dir = 1
	},
/obj/item/kirbyplants{
	icon_state = "plant-21"
	},
/obj/effect/turf_decal/tile/blue/half/contrasted{
	dir = 4
	},
/turf/open/floor/holofloor{
	icon_state = "white"
	},
/area/template_noop)
"eQ" = (
/obj/effect/turf_decal/tile/red/anticorner/contrasted{
	dir = 8
	},
/turf/open/floor/holofloor{
	icon_state = "white"
	},
/area/template_noop)
"jr" = (
/obj/effect/turf_decal/tile/blue,
/turf/open/floor/holofloor{
	icon_state = "white"
	},
/area/template_noop)
"jy" = (
/obj/structure/bed,
/obj/item/bedsheet/medical,
/obj/effect/turf_decal/tile/green/anticorner/contrasted{
	dir = 1
	},
/turf/open/floor/holofloor{
	icon_state = "white"
	},
/area/template_noop)
"kb" = (
/obj/machinery/shower/directional/east,
/obj/effect/turf_decal/tile/blue/anticorner/contrasted{
	dir = 8
	},
/turf/open/floor/holofloor{
	icon_state = "white"
	},
/area/template_noop)
"kn" = (
/obj/structure/window{
	dir = 1
	},
/obj/structure/table/glass,
/obj/item/healthanalyzer,
/obj/effect/turf_decal/tile/blue/half/contrasted{
	dir = 4
	},
/turf/open/floor/holofloor{
	icon_state = "white"
	},
/area/template_noop)
"lF" = (
/obj/structure/table/optable,
/obj/effect/turf_decal/tile/red/half/contrasted{
	dir = 8
	},
/turf/open/floor/holofloor{
	icon_state = "white"
	},
/area/template_noop)
"nd" = (
/obj/structure/window{
	dir = 1
	},
/obj/structure/bed/roller,
/obj/effect/turf_decal/tile/blue/half/contrasted{
	dir = 4
	},
/turf/open/floor/holofloor{
	icon_state = "white"
	},
/area/template_noop)
"nC" = (
/obj/effect/turf_decal/tile/blue/opposingcorners{
	dir = 1
	},
/turf/open/floor/holofloor{
	icon_state = "white"
	},
/area/template_noop)
"oE" = (
/obj/machinery/computer/operating{
	dir = 8
	},
/obj/effect/turf_decal/tile/red/half/contrasted{
	dir = 8
	},
/turf/open/floor/holofloor{
	icon_state = "white"
	},
/area/template_noop)
"pr" = (
/obj/structure/window{
	dir = 1
	},
/obj/effect/turf_decal/tile/blue/anticorner/contrasted{
	dir = 4
	},
/turf/open/floor/holofloor{
	icon_state = "white"
	},
/area/template_noop)
"pU" = (
/obj/machinery/computer/operating{
	dir = 4
	},
/obj/effect/turf_decal/tile/red/half/contrasted{
	dir = 8
	},
/turf/open/floor/holofloor{
	icon_state = "white"
	},
/area/template_noop)
"rm" = (
/obj/machinery/stasis,
/obj/effect/turf_decal/tile/green/anticorner/contrasted,
/turf/open/floor/holofloor{
	icon_state = "white"
	},
/area/template_noop)
"rX" = (
/obj/structure/window{
	dir = 8
	},
/obj/machinery/computer/records/medical{
	dir = 4
	},
/obj/effect/turf_decal/tile/blue/opposingcorners{
	dir = 1
	},
/turf/open/floor/holofloor{
	icon_state = "white"
	},
/area/template_noop)
"ti" = (
/obj/structure/table/glass,
/obj/item/clothing/gloves/latex/nitrile,
/obj/item/clothing/suit/apron/surgical,
/obj/item/clothing/mask/surgical,
/obj/structure/window{
	dir = 4
	},
/obj/item/surgicaldrill,
/obj/effect/turf_decal/tile/red/anticorner/contrasted,
/turf/open/floor/holofloor{
	icon_state = "white"
	},
/area/template_noop)
"tI" = (
/turf/open/floor/holofloor{
	icon_state = "white"
	},
/area/template_noop)
"tM" = (
/obj/effect/turf_decal/tile/blue/anticorner/contrasted{
	dir = 4
	},
/turf/open/floor/holofloor{
	icon_state = "white"
	},
/area/template_noop)
"uF" = (
/obj/structure/window,
/obj/item/kirbyplants{
	icon_state = "plant-10"
	},
/obj/effect/turf_decal/tile/blue/half/contrasted{
	dir = 8
	},
/turf/open/floor/holofloor{
	icon_state = "white"
	},
/area/template_noop)
"vC" = (
/obj/effect/turf_decal/tile/blue/half/contrasted{
	dir = 4
	},
/turf/open/floor/holofloor{
	icon_state = "white"
	},
/area/template_noop)
"vX" = (
/obj/effect/turf_decal/tile/yellow/half/contrasted{
	dir = 8
	},
/turf/open/floor/holofloor{
	icon_state = "white"
	},
/area/template_noop)
"wS" = (
/obj/structure/window{
	dir = 1
	},
/obj/structure/table/glass,
/obj/item/storage/box/masks,
/obj/effect/turf_decal/tile/blue/half/contrasted{
	dir = 4
	},
/turf/open/floor/holofloor{
	icon_state = "white"
	},
/area/template_noop)
"xc" = (
/obj/machinery/door/window/left/directional/west{
	dir = 2
	},
/obj/effect/turf_decal/tile/blue/half/contrasted{
	dir = 8
	},
/turf/open/floor/holofloor{
	icon_state = "white"
	},
/area/template_noop)
"ya" = (
/obj/machinery/washing_machine,
/obj/effect/turf_decal/tile/blue/opposingcorners{
	dir = 1
	},
/turf/open/floor/holofloor{
	icon_state = "white"
	},
/area/template_noop)
"yz" = (
/obj/structure/table/glass,
/obj/item/scalpel{
	pixel_y = 10
	},
/obj/item/circular_saw,
/obj/effect/turf_decal/tile/red/half/contrasted{
	dir = 4
	},
/turf/open/floor/holofloor{
	icon_state = "white"
	},
/area/template_noop)
"zP" = (
/obj/structure/chair/office/light{
	dir = 8
	},
/obj/effect/turf_decal/tile/blue/opposingcorners{
	dir = 1
	},
/turf/open/floor/holofloor{
	icon_state = "white"
	},
/area/template_noop)
"zU" = (
/obj/structure/window,
/obj/effect/turf_decal/tile/blue/half/contrasted{
	dir = 8
	},
/turf/open/floor/holofloor{
	icon_state = "white"
	},
/area/template_noop)
"AG" = (
/obj/structure/window{
	dir = 8
	},
/obj/machinery/computer/crew{
	dir = 4
	},
/obj/effect/turf_decal/tile/blue/opposingcorners{
	dir = 1
	},
/turf/open/floor/holofloor{
	icon_state = "white"
	},
/area/template_noop)
"AS" = (
/obj/effect/turf_decal/tile/blue/anticorner/contrasted{
	dir = 1
	},
/turf/open/floor/holofloor{
	icon_state = "white"
	},
/area/template_noop)
"Bs" = (
/obj/structure/table,
/obj/item/flashlight/lamp,
/obj/structure/window{
	dir = 8
	},
/obj/effect/turf_decal/tile/blue/opposingcorners{
	dir = 1
	},
/turf/open/floor/holofloor{
	icon_state = "white"
	},
/area/template_noop)
"Cc" = (
/obj/structure/window{
	dir = 1
	},
/obj/structure/table/glass,
/obj/item/storage/box/gloves{
	pixel_x = 3;
	pixel_y = 3
	},
/obj/effect/turf_decal/tile/blue/half/contrasted{
	dir = 4
	},
/turf/open/floor/holofloor{
	icon_state = "white"
	},
/area/template_noop)
"Cj" = (
/obj/structure/window,
/obj/effect/turf_decal/tile/blue/anticorner/contrasted,
/turf/open/floor/holofloor{
	icon_state = "white"
	},
/area/template_noop)
"CL" = (
/obj/structure/table/glass,
/obj/item/stack/medical/gauze,
/obj/item/cautery,
/obj/effect/turf_decal/tile/red/half/contrasted{
	dir = 4
	},
/turf/open/floor/holofloor{
	icon_state = "white"
	},
/area/template_noop)
"Em" = (
/obj/effect/turf_decal/tile/blue/half/contrasted,
/turf/open/floor/holofloor{
	icon_state = "white"
	},
/area/template_noop)
"GC" = (
/obj/machinery/iv_drip,
/obj/effect/turf_decal/tile/green/half/contrasted{
	dir = 8
	},
/turf/open/floor/holofloor{
	icon_state = "white"
	},
/area/template_noop)
"Il" = (
/obj/structure/table,
/obj/item/reagent_containers/cup/beaker,
/obj/item/reagent_containers/cup/beaker,
/obj/item/reagent_containers/cup/beaker,
/obj/effect/turf_decal/tile/yellow/anticorner/contrasted{
	dir = 1
	},
/turf/open/floor/holofloor{
	icon_state = "white"
	},
/area/template_noop)
"KZ" = (
/obj/structure/closet/wardrobe/white,
/obj/effect/turf_decal/tile/blue/opposingcorners{
	dir = 1
	},
/turf/open/floor/holofloor{
	icon_state = "white"
	},
/area/template_noop)
"LP" = (
/obj/machinery/stasis{
	dir = 4
	},
/obj/effect/turf_decal/tile/green/half/contrasted{
	dir = 8
	},
/turf/open/floor/holofloor{
	icon_state = "white"
	},
/area/template_noop)
"MM" = (
/obj/machinery/computer/pandemic,
/obj/effect/turf_decal/tile/yellow/anticorner/contrasted,
/turf/open/floor/holofloor{
	icon_state = "white"
	},
/area/template_noop)
"Nq" = (
/obj/effect/turf_decal/tile/green/half/contrasted{
	dir = 1
	},
/turf/open/floor/holofloor{
	icon_state = "white"
	},
/area/template_noop)
"NV" = (
/obj/effect/turf_decal/tile/blue{
	dir = 1
	},
/turf/open/floor/holofloor{
	icon_state = "white"
	},
/area/template_noop)
"Oa" = (
/obj/machinery/iv_drip,
/obj/effect/turf_decal/tile/green/anticorner/contrasted{
	dir = 8
	},
/turf/open/floor/holofloor{
	icon_state = "white"
	},
/area/template_noop)
"Qe" = (
/obj/structure/table,
/obj/item/reagent_containers/dropper,
/obj/item/assembly/igniter,
/obj/effect/turf_decal/tile/yellow/anticorner/contrasted{
	dir = 4
	},
/turf/open/floor/holofloor{
	icon_state = "white"
	},
/area/template_noop)
"QS" = (
/obj/effect/turf_decal/tile/red/half/contrasted{
	dir = 1
	},
/turf/open/floor/holofloor{
	icon_state = "white"
	},
/area/template_noop)
"RB" = (
/obj/structure/window{
	dir = 1
	},
/obj/item/kirbyplants{
	icon_state = "plant-08"
	},
/obj/effect/turf_decal/tile/blue/half/contrasted{
	dir = 4
	},
/turf/open/floor/holofloor{
	icon_state = "white"
	},
/area/template_noop)
"Sr" = (
/obj/structure/table,
/obj/item/folder/white,
/obj/effect/turf_decal/tile/blue/opposingcorners{
	dir = 1
	},
/turf/open/floor/holofloor{
	icon_state = "white"
	},
/area/template_noop)
"Tf" = (
/obj/structure/table,
/obj/machinery/reagentgrinder,
/obj/effect/turf_decal/tile/yellow/half/contrasted,
/turf/open/floor/holofloor{
	icon_state = "white"
	},
/area/template_noop)
"UA" = (
/obj/structure/bodycontainer/morgue{
	dir = 2
	},
/obj/effect/turf_decal/tile/red/anticorner/contrasted{
	dir = 1
	},
/turf/open/floor/holofloor{
	icon_state = "white"
	},
/area/template_noop)
"UC" = (
/obj/structure/table,
/obj/item/storage/box/syringes,
/obj/effect/turf_decal/tile/yellow/anticorner/contrasted{
	dir = 8
	},
/turf/open/floor/holofloor{
	icon_state = "white"
	},
/area/template_noop)
"Ve" = (
/obj/structure/bed,
/obj/item/bedsheet/medical,
/obj/effect/turf_decal/tile/green/half/contrasted{
	dir = 4
	},
/turf/open/floor/holofloor{
	icon_state = "white"
	},
/area/template_noop)
"VC" = (
/obj/machinery/shower/directional/east,
/obj/effect/turf_decal/tile/blue/half/contrasted{
	dir = 1
	},
/turf/open/floor/holofloor{
	icon_state = "white"
	},
/area/template_noop)
"WM" = (
/obj/structure/filingcabinet,
/obj/effect/turf_decal/tile/blue/opposingcorners{
	dir = 1
	},
/turf/open/floor/holofloor{
	icon_state = "white"
	},
/area/template_noop)
"Yl" = (
/obj/structure/table,
/obj/item/paper_bin,
/obj/item/pen,
/obj/effect/turf_decal/tile/blue/opposingcorners{
	dir = 1
	},
/turf/open/floor/holofloor{
	icon_state = "white"
	},
/area/template_noop)
"Yv" = (
/obj/structure/table,
/obj/item/clothing/neck/stethoscope,
/obj/effect/turf_decal/tile/blue/opposingcorners{
	dir = 1
	},
/turf/open/floor/holofloor{
	icon_state = "white"
	},
/area/template_noop)
"Yy" = (
/obj/effect/turf_decal/tile/green/half/contrasted,
/turf/open/floor/holofloor{
	icon_state = "white"
	},
/area/template_noop)
"Ze" = (
/obj/structure/closet/crate/freezer/blood,
/obj/structure/window{
	dir = 4
	},
/obj/effect/turf_decal/tile/red/anticorner/contrasted{
	dir = 4
	},
/turf/open/floor/holofloor{
	icon_state = "white"
	},
/area/template_noop)
"Zf" = (
/obj/machinery/chem_master,
/obj/effect/turf_decal/tile/yellow/half/contrasted{
	dir = 4
	},
/turf/open/floor/holofloor{
	icon_state = "white"
	},
/area/template_noop)

(1,1,1) = {"
UA
QS
eQ
AS
kb
VC
ab
jy
Nq
Oa
"}
(2,1,1) = {"
cL
tI
lF
eG
jr
NV
zU
Ve
tI
LP
"}
(3,1,1) = {"
yz
tI
oE
wS
jr
NV
zU
Ve
tI
GC
"}
(4,1,1) = {"
bZ
tI
pU
kn
jr
NV
xc
bU
Yy
rm
"}
(5,1,1) = {"
CL
tI
lF
Cc
jr
NV
uF
AG
rX
Bs
"}
(6,1,1) = {"
Ze
cx
ti
nd
jr
NV
zU
nC
zP
Sr
"}
(7,1,1) = {"
Il
ar
UC
RB
jr
NV
xc
nC
nC
Yl
"}
(8,1,1) = {"
Zf
tI
vX
vC
jr
NV
zU
KZ
nC
Yv
"}
(9,1,1) = {"
Qe
Tf
MM
pr
Em
tM
Cj
ya
nC
WM
"}
