//MAP CONVERTED BY dmm2tgm.py THIS HEADER COMMENT PREVENTS RECONVERSION, DO NOT REMOVE
"b" = (
/obj/effect/turf_decal/tile/green/half/contrasted{
	dir = 8
	},
/turf/open/floor/holofloor,
/area/template_noop)
"d" = (
/obj/effect/turf_decal/tile/red/half/contrasted{
	dir = 1
	},
/turf/open/floor/holofloor,
/area/template_noop)
"f" = (
/obj/effect/turf_decal/tile/red/anticorner/contrasted{
	dir = 4
	},
/turf/open/floor/holofloor,
/area/template_noop)
"r" = (
/obj/effect/turf_decal/tile/green/anticorner/contrasted{
	dir = 8
	},
/turf/open/floor/holofloor,
/area/template_noop)
"z" = (
/obj/effect/turf_decal/tile/green/anticorner/contrasted,
/turf/open/floor/holofloor,
/area/template_noop)
"B" = (
/obj/effect/turf_decal/tile/red/half/contrasted{
	dir = 4
	},
/turf/open/floor/holofloor,
/area/template_noop)
"D" = (
/turf/open/floor/holofloor,
/area/template_noop)
"G" = (
/obj/effect/turf_decal/tile/red/half/contrasted,
/turf/open/floor/holofloor,
/area/template_noop)
"M" = (
/obj/effect/turf_decal/tile/green/half/contrasted{
	dir = 1
	},
/turf/open/floor/holofloor,
/area/template_noop)
"S" = (
/obj/effect/turf_decal/tile/green/half/contrasted,
/turf/open/floor/holofloor,
/area/template_noop)
"T" = (
/obj/effect/turf_decal/tile/red/anticorner/contrasted{
	dir = 1
	},
/turf/open/floor/holofloor,
/area/template_noop)

(1,1,1) = {"
T
d
d
d
d
M
M
M
M
r
"}
(2,1,1) = {"
B
D
D
D
D
D
D
D
D
b
"}
(3,1,1) = {"
B
D
D
D
D
D
D
D
D
b
"}
(4,1,1) = {"
B
D
D
D
D
D
D
D
D
b
"}
(5,1,1) = {"
B
D
D
D
D
D
D
D
D
b
"}
(6,1,1) = {"
B
D
D
D
D
D
D
D
D
b
"}
(7,1,1) = {"
B
D
D
D
D
D
D
D
D
b
"}
(8,1,1) = {"
B
D
D
D
D
D
D
D
D
b
"}
(9,1,1) = {"
f
G
G
G
G
S
S
S
S
z
"}
