//MAP CONVERTED BY dmm2tgm.py THIS HEADER COMMENT PREVENTS RECONVERSION, DO NOT REMOVE
"d" = (
/obj/effect/turf_decal/tile/red/anticorner/contrasted{
	dir = 4
	},
/turf/open/floor/holofloor,
/area/template_noop)
"e" = (
/obj/effect/turf_decal/tile/green/half/contrasted{
	dir = 8
	},
/turf/open/floor/holofloor,
/area/template_noop)
"j" = (
/obj/effect/turf_decal/tile/green/half/contrasted,
/turf/open/floor/holofloor,
/area/template_noop)
"l" = (
/obj/effect/turf_decal/tile/red/half/contrasted{
	dir = 1
	},
/turf/open/floor/holofloor,
/area/template_noop)
"r" = (
/obj/machinery/readybutton,
/obj/effect/turf_decal/tile/red/anticorner/contrasted{
	dir = 1
	},
/turf/open/floor/holofloor,
/area/template_noop)
"s" = (
/obj/effect/turf_decal/tile/red/half/contrasted{
	dir = 4
	},
/turf/open/floor/holofloor,
/area/template_noop)
"u" = (
/obj/structure/window{
	dir = 1
	},
/obj/item/toy/beach_ball/holoball/dodgeball,
/obj/effect/turf_decal/tile/red/half/contrasted{
	dir = 8
	},
/turf/open/floor/holofloor,
/area/template_noop)
"x" = (
/obj/effect/turf_decal/tile/green/half/contrasted{
	dir = 1
	},
/turf/open/floor/holofloor,
/area/template_noop)
"A" = (
/obj/effect/turf_decal/tile/red/half/contrasted{
	dir = 8
	},
/turf/open/floor/holofloor,
/area/template_noop)
"D" = (
/obj/effect/turf_decal/tile/green/half/contrasted{
	dir = 4
	},
/turf/open/floor/holofloor,
/area/template_noop)
"I" = (
/obj/effect/turf_decal/tile/green/anticorner/contrasted{
	dir = 8
	},
/turf/open/floor/holofloor,
/area/template_noop)
"M" = (
/obj/machinery/readybutton,
/obj/effect/turf_decal/tile/green/anticorner/contrasted,
/turf/open/floor/holofloor,
/area/template_noop)
"N" = (
/obj/structure/window{
	dir = 1
	},
/obj/item/toy/beach_ball/holoball/dodgeball,
/obj/effect/turf_decal/tile/red/anticorner/contrasted{
	dir = 8
	},
/turf/open/floor/holofloor,
/area/template_noop)
"O" = (
/obj/effect/turf_decal/tile/red/half/contrasted,
/turf/open/floor/holofloor,
/area/template_noop)
"P" = (
/obj/structure/window,
/obj/item/toy/beach_ball/holoball/dodgeball,
/obj/effect/turf_decal/tile/green/half/contrasted{
	dir = 4
	},
/turf/open/floor/holofloor,
/area/template_noop)
"S" = (
/obj/structure/window{
	dir = 1
	},
/obj/item/toy/beach_ball/holoball/dodgeball,
/obj/effect/turf_decal/tile/red/anticorner/contrasted,
/turf/open/floor/holofloor,
/area/template_noop)
"T" = (
/obj/structure/window,
/obj/item/toy/beach_ball/holoball/dodgeball,
/obj/effect/turf_decal/tile/green/anticorner/contrasted{
	dir = 4
	},
/turf/open/floor/holofloor,
/area/template_noop)
"X" = (
/turf/open/floor/holofloor,
/area/template_noop)
"Z" = (
/obj/structure/window,
/obj/item/toy/beach_ball/holoball/dodgeball,
/obj/effect/turf_decal/tile/green/anticorner/contrasted{
	dir = 1
	},
/turf/open/floor/holofloor,
/area/template_noop)

(1,1,1) = {"
r
l
l
l
N
Z
x
x
x
I
"}
(2,1,1) = {"
s
X
A
X
u
P
X
D
X
e
"}
(3,1,1) = {"
s
X
A
X
u
P
X
D
X
e
"}
(4,1,1) = {"
s
X
A
X
u
P
X
D
X
e
"}
(5,1,1) = {"
s
X
A
X
u
P
X
D
X
e
"}
(6,1,1) = {"
s
X
A
X
u
P
X
D
X
e
"}
(7,1,1) = {"
s
X
A
X
u
P
X
D
X
e
"}
(8,1,1) = {"
s
X
A
X
u
P
X
D
X
e
"}
(9,1,1) = {"
d
O
O
O
S
T
j
j
j
M
"}
